Input	Target	Predicted
ank	अंक	अंक
anka	अंक	अंका
ankit	अंकित	एंकित
anakon	अंकों	अंकों
ankhon	अंकों	अंकों
ankon	अंकों	अंकों
angkor	अंकोर	अंगकर
ankor	अंकोर	अंकोर
angaarak	अंगारक	अंगारक
angarak	अंगारक	अंगररक
angraji	अंग्रज़ी	अंगराजी
angreji	अंग्रज़ी	अं्रेजी
angrzi	अंग्रज़ी	अंगरीजी
antah	अंतः	अंतः
antaha	अंतः	अंताा
antarmukh	अंतर्मुख	अंतरमकख
antmurkh	अंतर्मुख	अंतरुर्ख
antrmukh	अंतर्मुख	अंतर्मुख
andrabee	अंद्राबी	अंदररबी
andrabi	अंद्राबी	अंदररबी
andha	अंधा	अंधा
andhapan	अंधापन	अंधपान
andheri	अंधेरी	अंधररी
ambaani	अंबानी	अंबानी
ambani	अंबानी	अंबानी
akram	अकरम	अक्रम
acapulco	अकापुल्को	अकापुल्को
akapulko	अकापुल्को	अकापपककों
akhand	अखंड	अखांड
akhil	अखिल	अखिल
agavai	अगवाई	अगवईई
agvaai	अगवाई	अगवाई
augustine	अगस्टाइन	असस्त्ीन
augustustine	अगस्टाइन	असग्स््टेनन
agsta	अगस्ता	अगस्त
agusta	अगस्ता	अगुस्त
augusta	अगस्ता	असस्तत
agr	अग्र	अग्र
agra	अग्र	अग्र
achambha	अचंभा	अचंभा
achanbha	अचंभा	अचंभा
achievement	अचीवमेंट	अचीवेमेट
achivement	अचीवमेंट	अचिवाेेट
acchi	अच्छी	अचीची
achchi	अच्छी	अच्ची
achhi	अच्छी	अच्छी
achyut	अच्युत	अछूत
achhanera	अछनेरा	अछ्नेर
achnera	अछनेरा	अचेना
ajmeedh	अजमीढ़	अजमीध
ajhar	अजहर	अजार
azhar	अजहर	अजहर
ajit	अजित	अजित
agnat	अज्ञात	अज्ञात
agyaat	अज्ञात	अज्ञात
agyat	अज्ञात	अज्ञत
atakta	अटकता	अकतता
atkata	अटकता	अटकता
atake	अटके	अटके
atke	अटके	अटेक
atwaal	अटवाल	अत्वल
atwal	अटवाल	अत्वल
attahasa	अट्टहास	अत्थहास
atthaas	अट्टहास	अत्थास
atthas	अट्टहास	अट्टहास
addon	अड्डों	एड़नो
athak	अथक	अठक
atharv	अथर्व	अठररव
atharva	अथर्व	अठरवा
adad	अदद	अदाद
adaani	अदाणी	अदानी
adani	अदाणी	अदानी
advait	अद्वैत	अदवात
adwait	अद्वैत	एडवाइट
advaitvaad	अद्वैतवाद	अदववतवाद
advaitwad	अद्वैतवाद	अदववतववाद
adhivas	अधिवास	अधिवास
adhiwas	अधिवास	अधिवास
advivas	अधिवास	एडवववसस
adhiik	अधीक	अधीक
adhik	अधीक	अधिक
adhyayanarat	अध्ययनरत	अध्ययनातत
adhyayanrat	अध्ययनरत	अध्ययनर्त
adhyaynrat	अध्ययनरत	अध्ययनर््
anant	अनंत	अनांत
ananti	अनंती	अनातत
angadh	अनगढ़	अंगा़
angarh	अनगढ़	अंगरा
anchahe	अनचाहे	अंचहे
anthak	अनथक	अंथक
unthak	अनथक	उंठक
anhoni	अनहोनी	अनहहोनी
anaavashyak	अनावश्यक	अनावाश्क
anavashyak	अनावश्यक	अनववाश्क
anavshyak	अनावश्यक	अनावश्यक
anawashyak	अनावश्यक	अन्वाश््क
anik	अनिक	अनिक
anishwarvadi	अनीश्वरवादी	अनिश्वत्वादी
anishwarwadi	अनीश्वरवादी	अनिश्वत्वादी
anukoltha	अनुकूलता	अनुकोलता
anukulata	अनुकूलता	अनुकुलता
anukulta	अनुकूलता	अनुकुलता
anuchit	अनुचित	अनुचित
anuprayogi	अनुप्रयोगों	अनुप्ररागी
anuprayogon	अनुप्रयोगों	अनुप्रमागों
anupryogon	अनुप्रयोगों	अनुप्रमिगों
anureet	अनुरीत	अनुरित
anurit	अनुरीत	अनुरित
anuthi	अनूठी	अनुठि
anudit	अनूदित	अनुदित
anyaay	अन्याय	अन्याय
anyay	अन्याय	अन्यय
anyaya	अन्याय	अन्याय
apnani	अपनानी	अपनानी
aparivartanshali	अपरिवर्तनशील	अपरिवर्पाीली
aparivartansheel	अपरिवर्तनशील	अपरिवर्पनील
aparivartanshil	अपरिवर्तनशील	अपरिवर्वाीलल
apariharya	अपरिहार्य	अपरिहर्य
aprihary	अपरिहार्य	अपरिहार
apriyary	अपरिहार्य	अप्रयार्य
apavartit	अपवर्तित	अपवर्तित
apvartit	अपवर्तित	अपवरततत
apvtrit	अपवर्तित	अपव्तित
apaardarshi	अपारदर्शी	अपरादर्शी
apardarshi	अपारदर्शी	अपररद्शी
afroj	अफरोज	अफररज
afroz	अफरोज	अफ्रजज
africa	अफ्रीका	अफ्रिका
abbaasi	अब्बासी	अब्ाासी
abbasi	अब्बासी	अब्साी
abhimat	अभिमत	अभिमत
abhishap	अभिशाप	अभिष्प
abhi	अभी	अभी
amjhera	अमझेरा	अमजेरा
amzera	अमझेरा	अमजेरा
amargad	अमरगढ़	अमरगाद
amargarh	अमरगढ़	अमरगगढ़
amarpaal	अमरपाल	अमरपपल
amarpal	अमरपाल	अमरपपल
amarohi	अमरोही	अमारोही
amrohi	अमरोही	अमरोही
amaanat	अमानत	अमानत
amanat	अमानत	अमानत
amanth	अमानत	अमांथ
amaanati	अमानती	अमानती
amanathi	अमानती	अमानथी
amanati	अमानती	अमानती
amavasya	अमावस्या	अमााससय
amavsya	अमावस्या	अमासव्य
amit	अमित	अमित
amitao	अमिताव	अमिताए
amitav	अमिताव	अमिताव
amuk	अमुक	अमूक
amogh	अमोघ	अमोग
ambani	अम्बानी	अंबानी
ayodhyaanaath	अयोध्यानाथ	अयोद्यनथथ
ayodhyanaath	अयोध्यानाथ	अयोद्यनथथ
ayodhyanath	अयोध्यानाथ	अयोद्यनथथ
ayodhyeanath	अयोध्यानाथ	अयोद्यानथथ
aradas	अरदास	अरदास
ardaas	अरदास	अर्दास
ardas	अरदास	अर्दस
arabab	अरबाब	अरबब
arbab	अरबाब	अरबब
around	अराउंड	आरोउं
arjent	अर्जेंट	अर्जेट
urgent	अर्जेंट	उर्जेंट
arth	अर्थ	अर्थ
artha	अर्थ	अर्था
earth	अर्थ	इर्थ
earthquake	अर्थक्वेक	इर्थथेक
arthon	अर्थों	अर्थों
arpit	अर्पित	अर्पित
aryama	अर्यमा	आर्याम
aryma	अर्यमा	आर्मा
arymaa	अर्यमा	अर्या
alankaar	अलंकार	अलंकर
alankar	अलंकार	अलंकर
alnkaar	अलंकार	अलंकर
alankaaron	अलंकारों	अलंकरणों
alankaron	अलंकारों	अलंकरोों
alnkaaron	अलंकारों	अलंकररों
alnkaron	अलंकारों	अलंकरों
alagavavadi	अलगाववादी	अलागवादीी
algavvadi	अलगाववादी	अल्ववाददी
algavwaadi	अलगाववादी	अल्ववाादी
alive	अलाइव	एलीव
alance	अलायंस	अलेंस
alayans	अलायंस	अलांस
aliance	अलायंस	एलाइंस
alind	अलिंद	एलिंड
alai	अली	अलाई
ali	अली	अली
alii	अली	अली
alonso	अलोंसो	एलॉससन
aloso	अलोंसो	अलोसो
alphabet	अल्फ़ाबेट	अल्फाबेट
alba	अल्बा	अल्ब
avantipur	अवंतिपुर	अवंतिपुर
awantipora	अवंतिपुर	अवंतिपुरा
avaru	अवरु	अवरु
avru	अवरु	अवूू
awaru	अवरु	अवरू
avarodhak	अवरोधक	अवरोधक
avrodhak	अवरोधक	अवरोधक
avrodhk	अवरोधक	अवरोधक
avarnata	अवर्णता	अवर्णता
avarnataa	अवर्णता	अवर्णता
avranta	अवर्णता	अवरंता
avashist	अवशिष्ट	आवशिष्ट
avshisht	अवशिष्ट	अवशिष्ट
awashist	अवशिष्ट	आवशिष्ट
avasthaayen	अवस्थाएं	अवस्थाएं
avsthaen	अवस्थाएं	अवस्थाएं
avsthayen	अवस्थाएं	अवस्थाएं
awasthaen	अवस्थाएं	अवस्थाएं
avi	अवि	अवी
avika	अविका	अविका
aviral	अविरल	अविरा
avirl	अविरल	अविर्
avishvaasniy	अविश्वसनीय	अविश्वसनीय
avishvasniy	अविश्वसनीय	अविश्वसनीय
avishvasniya	अविश्वसनीय	अविश्वससीय
avisvasniya	अविश्वसनीय	अविस्वसीयय
aviva	अवीवा	अविवा
avaigyanic	अवैज्ञानिक	अवैग्ञािि
avaigyanik	अवैज्ञानिक	अवैज्ञानिक
avegyanik	अवैज्ञानिक	अवेग्ञानिक
ashaktataa	अशक्तता	अषक्तता
ashktta	अशक्तता	अष्कतता
asharaphi	अशरफी	अशाराी
ashrafi	अशरफी	अशराी
ashariri	अशरीरी	अशारी
ashriri	अशरीरी	अश्री
ashrvatath	अश्वत्थ	अश्रव्था
ashvtth	अश्वत्थ	अश्वत्ठ
asamaany	असमान्य	असमाान्य
asamany	असमान्य	असममान्य
asmanye	असमान्य	असममानयय
asaamnjsy	असामंजस्य	असममजज्य
asamanjasy	असामंजस्य	असमाजनसय
asamanjasya	असामंजस्य	असमाजनसय
asurakshit	असुरक्षित	असुरक्षित
asurkshit	असुरक्षित	असुरक्षित
aset	असेट	असेट
asset	असेट	एसेट
asvabhavik	अस्वभाविक	अस्वाभावि
aswabhavik	अस्वभाविक	अस्वाभाविक
aswbhavik	अस्वभाविक	अस्वाभविक
ahirauli	अहिरौली	अहिराली
item	आइटम	आइटम
items	आइटम्स	आइटेस
idle	आइडल	आइडल
idol	आइडल	आइडल
icc	आइसीसी	आईसीसी
iso	आइसो	आसस
ipc	आईपीसी	आईसीसी
ipad	आईपैड	आईपैड
iris	आईरिस	आइरिस
ounce	आउंस	आउउस
aakaash	आकाश	आकाश
aakash	आकाश	आकाश
aake	आके	आके
aakhet	आखेट	आखेत
akhet	आखेट	अखेत
aagat	आगत	आगत
aagaman	आगमन	आगमन
aagman	आगमन	आगमान
aagaa	आग़ा	आगा
aagah	आग़ा	आगाह
agha	आग़ा	आगा
aagaashe	आगाशे	आगाश
aagashe	आगाशे	आगाे
agashe	आगाशे	अगाे
aajmaanaa	आजमाना	आजमाना
aajmana	आजमाना	आजमाना
aazmaanaa	आजमाना	आजमाना
aata	आटा	आता
ata	आटा	अटा
atta	आटा	अट्ाा
aatmayen	आत्माएं	आत्माएं
atmaen	आत्माएं	आत्माएं
aadaan	आदान	आदान
aadan	आदान	आदान
aadhaarit	आधारित	आधारित
aadharit	आधारित	आधारित
adharit	आधारित	आधारित
aadheen	आधीन	आधीन
aadhin	आधीन	आधिन
aadhunik	आधुनिक	आधुनिक
aanad	आनद	आनाद
aanand	आनद	आनंद
anand	आनद	अनंद
aapka	आपका	आपका
aapkaa	आपका	आपका
aapadaaaen	आपदाएं	आपदाएं
aapdaein	आपदाएं	आपदाएं
aapdayein	आपदाएं	आपदाएं
aabantit	आबंटित	आबांतत
abantit	आबंटित	अबांतत
aabru	आबरू	आबरू
abaru	आबरू	अबाूू
aamdan	आमदन	आमदन
amadan	आमदन	अमादन
aamdani	आमदनी	आमदनन
amadani	आमदनी	अमादनी
aamdi	आमदी	आमदी
amdi	आमदी	अम्दी
aamod	आमोद	आमोड
amod	आमोद	अमोद
aayenge	आयेंगे	आयंगे
aayojak	आयोजक	आयोजक
ro	आरओ	रो
rp	आरपी	आरपी
aaraam	आराम	आरा
aaram	आराम	आरम
aram	आराम	आरम
aarushi	आरुषि	आरुषि
arushi	आरुषि	अवूषी
artery	आर्टरी	अर्टीर
order	आर्डर	ओर्डर
aary	आर्य	आरी
aarya	आर्य	आर्य
arya	आर्य	आरयय
aaryika	आर्यिका	आरिकक
aryika	आर्यिका	आर्यिका
aarya	आर्यो	आर्यो
arya	आर्यो	आरयय
aryo	आर्यो	आर्यो
aaryan	आर्यों	आर्य
arya	आर्यों	आरयय
aryon	आर्यों	आर्यों
aalsi	आलसी	आलसी
alasi	आलसी	अलसी
aalochak	आलोचक	आलोचक
alochak	आलोचक	आलोचक
aalochakon	आलोचकों	आलोचकों
alochakon	आलोचकों	आलोचकों
aalha	आल्हा	आलाह
aalhaa	आल्हा	आलाह
alha	आल्हा	अल्हा
allah	आल्हा	अल्लाह
aawaazen	आवाज़ें	आवाज़ें
aawajen	आवाज़ें	आवाजें
awaazen	आवाज़ें	अवाजें
awazen	आवाज़ें	अवाजें
aawajon	आवाज़ों	आवाजों
aawazon	आवाज़ों	आवाजों
awaazon	आवाज़ों	अवाजों
awazon	आवाज़ों	अवाजों
aavishakaar	आविष्कार	आविषकका
aavishkaar	आविष्कार	आविष्कार
avishkar	आविष्कार	अविष्कार
aavriti	आवृत्ति	आवृति
aavritti	आवृत्ति	आवृत्ति
avuti	आवृत्ति	आवृत्ति
aavritiyon	आवृत्तियों	आवृतियों
aavrittiyon	आवृत्तियों	आवृत्तियों
avrutiyon	आवृत्तियों	आवृतियों
aashanka	आशंका	आशंका
ashanka	आशंका	अशंका
aashriton	आश्रितों	आश्रितों
ashriton	आश्रितों	अश्रोतों
aasaan	आसान	आसान
aasan	आसान	आसा
asan	आसान	असा
aastik	आस्तिक	आस्तिक
astik	आस्तिक	अस्तिक
aasteen	आस्तीन	आस्तिन
aastin	आस्तीन	आस्तिन
astin	आस्तीन	अस्तिन
aahnaan	आह्नान	आहनान
aahnan	आह्नान	आहनन
ahyan	आह्नान	अह्यन
england	इंग्लैंड	इंगललंड
engineer	इंजिनियर	इंजिनियर
introduction	इंट्रोडक्शन	इंटरोडेश्शन
insurance	इंश्योरेंस	इंसरंंस
ear	इअर	इअर
eyer	इअर	आयर
eon	इआन	इईन
iaan	इआन	आईन
ekattha	इकट्ठा	एकत्ठा
ikattha	इकट्ठा	इकत्ठा
ekatthi	इकठ्ठी	एकत्ठी
ekthi	इकठ्ठी	इकठ्ठी
ikatthi	इकठ्ठी	इकत्ठी
ekaee	इकाई	एकाई
ikai	इकाई	इकाई
ekaeyon	इकाईयों	एकाईयों
ikaiyon	इकाईयों	इकाईयों
ikarion	इकाईयों	इकारियो
economic	इकोनोमिक	इकॉनोमिक
ecuador	इक्वाडोर	इक्लरडर
equador	इक्वाडोर	एक्वेडर
equities	इक्विटीज	एक्टीटिस
ikvitija	इक्विटीज	इकवविहाज
ijaajat	इजाजत	इजाजतत
ijajat	इजाजत	इजजजतत
inhalation	इनहेलेशन	इन्हालेतो
inhaletion	इनहेलेशन	इन्हेमेशन
ibija	इबीजा	इबिजा
ibiza	इबीजा	इबिजा
imaging	इमेजिंग	इमाजिंग
immune	इम्युन	इम्यून
elaichi	इलाइची	इलाची
ilaichi	इलाइची	इलाची
ilayachi	इलाइची	इलाचाीी
ilayichi	इलाइची	इलायीची
elaaj	इलाज	एलाज
ilaaj	इलाज	इलाज
ilaj	इलाज	आलजज
ishaak	इशाक	इशाक
ishaaq	इशाक	इशाक
ishak	इशाक	इशाक
ishaara	इशारा	इशारा
ishaaraa	इशारा	इशारा
ishara	इशारा	इशरर
ishita	इशिता	इशिता
isht	इष्ट	इष्ट
isteefe	इस्तीफे	इस्तेफे
istife	इस्तीफे	इस्टेफे
ea	ईए	आई
ia	ईए	आईए
eater	ईटर	इटर
iter	ईटर	आटरर
email	ईमेल	एमेल
emailon	ईमेलों	एमालों
emelon	ईमेलों	इमेलो
evening	ईवनिंग	एवेंिंग
east	ईष्ट	ईस्ट
ishat	ईष्ट	इश्त
isht	ईष्ट	इष्ट
isaaiyon	ईसाइयों	ईसाइयों
isaiyon	ईसाइयों	ईसाइयों
isayiyon	ईसाइयों	ईसाईयों
ikhrul	उखरुल	इखूलल
ukhrool	उखरुल	उखरूल
ukhrul	उखरुल	उखृल
uchhalane	उछालने	उचलचने
uchhalne	उछालने	उचलचने
ujback	उज़्बेक	उज़ाकक
uzbek	उज़्बेक	उज़्बकक
uthane	उठने	उठने
uthne	उठने	उठने
uthaakar	उठाकर	उठाकर
uthakar	उठाकर	उठाकर
uthaapatak	उठापटक	उठापतक
uthapatak	उठापटक	उठापतक
uthen	उठें	उठें
udaan	उड़ान	उड़न
udan	उड़ान	उड़न
udaanaa	उड़ाना	उद़ना
udana	उड़ाना	उड़ना
udaane	उड़ाने	उड़ने
udane	उड़ाने	उड़ने
udaanen	उड़ानें	उद़नें
udanen	उड़ानें	उड़नें
udaanon	उड़ानों	उड़ानों
udanon	उड़ानों	उदानों
utane	उतने	उताेे
utaney	उतने	उताे
utne	उतने	उतने
uttara	उत्तरा	उत्तरा
uttra	उत्तरा	उत्तरर
utpan	उत्पन	उत्पन
udant	उदंत	उदांत
udghosh	उदघोष	उद्घोष
udar	उदर	उदर
uda	उदा	उड़ा
udaa	उदा	उड़ा
udakishuganj	उदाकिशुनगंज	उदाकििपदंज
udakishunganj	उदाकिशुनगंज	उदाकीिपिं्ज
unatees	उनतीस	यूनिटिस
untees	उनतीस	उनतीस
uniyal	उनियाल	यूनियल
upadraviyon	उपद्रवियों	उपद्रवियों
updravion	उपद्रवियों	उपद्रवियों
updraviyon	उपद्रवियों	उपद्रवियों
upadravi	उपद्रवी	उपद्रवी
updravi	उपद्रवी	उपद्रवी
upadrawon	उपद्रवों	उपद्रवों
updravon	उपद्रवों	उपद्रवों
upneta	उपनेता	उपनेता
upabhokta	उपभोक्ता	उपाोकतत
upbhokta	उपभोक्ता	उपचोतता
uplaksh	उपलक्ष्य	उपलक्ष
uplakshay	उपलक्ष्य	उपलक्षय
uplakshya	उपलक्ष्य	उपलक्षषय
uplabdh	उपलब्ध	उपल्भ
uplabdhiyon	उपलब्धियों	उपलबभ्धियों
uplabdhi	उपलब्धी	उपलबभ्ध
upakhyaanon	उपाख्यानों	उपाख्याों
upakhyanon	उपाख्यानों	उपखानयोों
ubuntu	उबंटू	उबूनतू
ubaal	उबाल	उबलल
ubal	उबाल	उबाल
ubhaara	उभारा	उभारा
ubhara	उभारा	उभरा
umanath	उमानाथ	उमानाथ
umesh	उमेश	उमेे
urf	उर्फ	यरफ
urfa	उर्फ	उरफा
urff	उर्फ	यरफफ
urvarakon	उर्वरकों	उर्ववकोो
urvarkon	उर्वरकों	उर्ववकों
urwarakon	उर्वरकों	उर्वरकों
urvarata	उर्वरता	उरववाता
urvarta	उर्वरता	उररवव्त
urwarta	उर्वरता	उररववता
ulate	उलटे	उलते
ulte	उलटे	उल्ेे
ulahana	उलाहना	उललहा
ulahna	उलाहना	उललना
ulema	उलेमा	उलेमा
ulemaon	उलेमाओं	उल्मेमां
usak	उसक	उसक
usaki	उसकी	उसकी
uski	उसकी	उसकी
usmein	उसमें	उसमेे
usmen	उसमें	उसमें
usi	उसी	उसी
ustara	उस्तरा	उस्तर
udharv	ऊर्ध्व	उधारव
udhrva	ऊर्ध्व	ऊर्ध्व
urdhav	ऊर्ध्व	उर्भाव
ushma	ऊष्मा	उषमम
rishicool	ऋषिकुल	रििचुल
rishikul	ऋषिकुल	ऋषििकु
rushikul	ऋषिकुल	ऋषिकुल
enzyme	एंजाइम	एंजजयमम
anton	एंटोन	अंटों
entone	एंटोन	इंटोन
antoni	एंटोनी	अंतोनी
antony	एंटोनी	अंटोनी
endometrial	एंडोमेट्रियल	एंडोटेट्टियम
andreas	एंड्रियास	एंड्रेस
als	एएलएस	अल्स
asi	एएसआई	एसी
eksaath	एकसाथ	एकसाठ
eksath	एकसाथ	एकस्ठ
ekaki	एकाकी	एककी
xm	एक्सएम	एक्सएम
egmor	एगमोर	एग्मर
egmore	एगमोर	एग्मोर
aj	एजे	अज
agende	एजेंडे	आजेंडे
adp	एडीपी	एडीपी
adain	एडेन	आदाएं
aden	एडेन	आडेन
edan	एडेन	एडा
addi	एड्डी	अदीदी
eddi	एड्डी	एड्डी
eddie	एड्डी	एडीी
eddy	एड्डी	एडडड
apj	एपीजे	अपज
ftii	एफटीआईआई	एफटीआईआई
abbott	एबट	एब्बटट
abut	एबट	अबूट
ebt	एबट	एब्ट
abvp	एबीवीपी	अब्पीप
abbot	एबोट	एबोट
abbott	एबोट	एब्बटट
mta	एमटीए	एमटीए
mtake	एमटेक	मैके
mtec	एमटेक	एमटीस
mtech	एमटेक	एमटेक
emerald	एमरल्ड	एमररल्ड
emrald	एमरल्ड	एमरल्ड
emil	एमिल	एमिल
emile	एमिल	एमिल
emily	एमिल	एमिली
amy	एमी	अम्
emi	एमी	एमी
airway	एयरवे	एयरवे
eyarave	एयरवे	एयरवे
eyarve	एयरवे	एयरवे
error	एरर	एरर
arica	एरिका	अरिका
erica	एरिका	एरिका
erika	एरिका	एरिका
aerobic	एरोबिक	एरोबिक
aerobics	एरोबिक	एयरो्िक्स
lte	एलटीई	एलटट
lti	एलटीई	एलटीई
allergic	एलर्जिक	अलेरगिक
eliminator	एलिमिनेटर	एलिमिनेटर
aliens	एलियंस	एलाइंस
alliance	एलियंस	एलाइंंस
asian	एशियन	एसिया
sfc	एसएफसी	सीसीसी
sk	एसके	एससस
spf	एसपीएफ	एीपीपी
association	एसोसिएशन	एसोसिइनशन
astar	एस्टर	एस्टर
aster	एस्टर	अस्टर
ester	एस्टर	एस्टर
aesthetics	एस्थेटिक	एस्टेट्क्स
asthetic	एस्थेटिक	अस्टेतिक
asfalt	एस्फाल्ट	असफलत
asphalt	एस्फाल्ट	एस्फाल्ट
asphault	एस्फाल्ट	अस्फूल
ahsaas	एहसास	अहसास
ehsaas	एहसास	एहसास
ehsas	एहसास	एहसास
aisa	एेसा	एसा
eesa	एेसा	ईसा
ainth	ऐंठ	ऐंठ
end	ऐंठ	एंड
enth	ऐंठ	ऐंठ
ainthey	ऐंठे	ऐंथी
enthe	ऐंठे	ऐंठे
aithan	ऐठन	ऐंठन
ethan	ऐठन	इठान
ethhan	ऐठन	ऐठ्न
ail	ऐल	एए
el	ऐल	ऐल
alaps	ऐल्प्स	ऐल्प्स
alps	ऐल्प्स	अल्प्स
aise	ऐसे	एसे
oxide	ऑक्साइड	ऑक्सेडड
oxy	ऑक्सी	ऑक्सी
offers	ऑफर्स	आफर्स
offshor	ऑफशोर	ओफकोर
offshore	ऑफशोर	आफकोर
official	ऑफिशियल	आफिकिल
okalahoma	ओकलाहोमा	ओकललोोमा
oklahoma	ओकलाहोमा	उकलाहोमा
oklahoma	ओक्लाहोमा	उकलाहोमा
ot	ओत	ओट
opel	ओपेल	ओपेल
obrayan	ओब्रायन	ओब्रायं
obrien	ओब्रायन	ओब्रिन
oran	ओरण	ओरन
orian	ओरियन	ओरियन
orion	ओरियन	ओरिनो
olavrishti	ओलावृष्टि	ओल्वृष्टि
ovum	ओवम	ओवमम
owem	ओवम	ओवम
oceanic	ओशनिक	ऑक्ननक
osaka	ओसाका	ओसका
auchity	औचित्य	औचिटी
auchitya	औचित्य	औचिट्य
audhyogikaran	औद्योगिकरण	औध्योगगकरण
audyogikarana	औद्योगिकरण	औद्योगिकरण
audyogikikaran	औद्योगिकरण	औद्योगिकरण
aurangabad	औरंगाबाद	औरंगबाद
aurora	औरोरा	औरोरा
aulakh	औलख	औला
kankad	कंकड़	काकाड
kankar	कंकड़	काकर
kankad	कंकर	काकाड
kankar	कंकर	काकर
kangan	कंगन	कंगन
conjunction	कंजंक्शन	कंंजन््शशन
contemporary	कंटेम्पररी	कंट्नोपररी
kanthahar	कंठहार	कंठहार
kanthhar	कंठहार	कंठर
composer	कंपोजर	कंपोपर
kambalon	कंबलों	कंबललों
kanblon	कंबलों	कांबलों
consultant	कंसलटेंट	कंससलटटंट
kakkad	कक्कड़	कक्कड़
kakkar	कक्कड़	कककक
kacche	कच्चे	कच्चे
kachche	कच्चे	कच्चे
karta	कटरा	करता
katra	कटरा	कटरर
cutlery	कटलरी	कटर्ी
katlari	कटलरी	कटलरर
katlary	कटलरी	कटागरर
katasaraj	कटासराज	कटासराज
kathfodave	कठफोड़वे	कठठप़़़वे
kathfodve	कठफोड़वे	कठठपे़़व
kathor	कठोर	कथोर
kathore	कठोर	कथोरे
kanika	कणिका	कानिका
kathai	कत्थई	कथाई
katthai	कत्थई	कट्थाई
katthaii	कत्थई	कट्थाई
convention	कनवेंशन	कननवेशनन
canals	कनाल	केनल्स
kanaal	कनाल	कनाल
kanal	कनाल	कााल
kanindham	कनिंघम	कनिंंभम
kaningham	कनिंघम	कनिंंघम
kanishthika	कनिष्ठिका	कनिष्थति
kanishthikaa	कनिष्ठिका	कनिष्ठतिक
kanishtika	कनिष्ठिका	कनिष्ततिक
kanyaayen	कन्याएं	कन्याएं
kanyaein	कन्याएं	कन्याएं
kanyayen	कन्याएं	कन्याएं
convention	कन्वेंशन	कननवेशनन
convocation	कन्वोकेशन	कननवेश्शन
cup	कप	कप
kap	कप	कपप
kapda	कपड़ा	कपड़ा
kpada	कपड़ा	कपाड़
kapdo	कपड़ो	कपड़ों
kapdon	कपड़ो	कपड़ों
kaping	कपिंग	कपपिंग
kping	कपिंग	कपिंग
kapolkalpana	कपोलकल्पना	कपोोलपपपलन
kabaddi	कबड्डी	कबादद़
kabr	कब्र	कबरर
kabra	कब्र	कबरर
kabren	कब्रें	कबरेे
kabron	कब्रों	कबररों
kamjor	कमज़ोर	कमजोर
kamzor	कमज़ोर	कमजजर
kamatar	कमतर	कमातर
kamtar	कमतर	कामतर
kalamjeet	कमलजीत	कमलजीत
kamaljeet	कमलजीत	कमलजजित
kamaauu	कमाऊ	कमाए
kamau	कमाऊ	कमा
kamaate	कमाते	कमाते
kamate	कमाते	कमाेे
kamere	कमेरे	कमेरे
kmere	कमेरे	ककरर
karanj	करंज	कराजज
kranj	करंज	क्णजज
karanjiya	करंजिया	करणजजजय
kardhe	करघे	कर्दे
karghe	करघे	कर्जे
karachana	करछना	कराचाा
karchhana	करछना	कर्चना
karna	करना	करणा
karpatri	करपात्री	कर्ततरर
karam	करम	कराम
karoor	करूर	करूर
karur	करूर	करूर
karnataka	कर्नाटका	कर्नतकक
karvi	कर्वी	करववी
kurvi	कर्वी	कूर्वी
kalmein	कलमें	कललमें
kalmen	कलमें	कललमें
kalraj	कलराज	कारजज
kalika	कलिका	कालिका
kalpanaon	कल्पनाओं	कललपपाओं
kalpnaon	कल्पनाओं	कालपपाओं
kavvaliyon	कव्वालियों	कववालियों
qawwaliyon	कव्वालियों	कवव्वलियों
kavvali	कव्वाली	कववाली
qawwali	कव्वाली	कव्वाली
kashton	कष्टों	कष्तों
kasarat	कसरत	कसरत
kasrat	कसरत	कसरत
kasara	कसारा	कसरा
kasida	कसीदा	कसीदा
kahane	कहने	कहाने
kahne	कहने	कहने
kahlaya	कहलाया	कहलाया
kahaniyon	कहानियों	कहानियों
kile	क़िले	कील
kanji	कांजी	कंंज
cant	कांट	कांट
kant	कांट	कंंट
kanti	कांति	कांत
kakoo	काकू	काकू
kaku	काकू	काकू
kaagaj	कागज़	कागज
kaagaz	कागज़	कागजज़
kagaj	कागज़	कागज
kagaz	कागज़	कागज़
kaaji	काजी	काजी
kaji	काजी	काजी
kazi	काजी	काजी
qazi	काजी	काजी
kajoo	काजू	कजजू
kaju	काजू	काजू
kapadi	कापड़ी	कपा़़
kapdi	कापड़ी	कापड़ी
kamraj	कामराज	कमरबाज
kamottejana	कामोत्तेजना	कमोतेतजजन
kamottejna	कामोत्तेजना	कमोोत््जन
kailana	कायलाना	कैलना
kaylana	कायलाना	काललन
carfi	कार्की	कारफ
karki	कार्की	कारकी
kartik	कार्तिक	कार्तिक
karyakartaon	कार्यकर्ताओं	कार्यक्रताओं
karykartaaon	कार्यकर्ताओं	कार्यक्रताओं
karykartaon	कार्यकर्ताओं	कार्यक्रताओं
karyabhar	कार्यभार	कार्यभर
karybhar	कार्यभार	कार्मभर
karyarat	कार्यरत	कार्यतत
karyrat	कार्यरत	कार्यत
kaalpi	कालपी	कालपी
kalapi	कालपी	कलापी
kalpi	कालपी	का्पी
kalika	कालिका	कालिका
kalighat	कालीघाट	कालीघाट
coldvel	काल्डवेल	कॉलववल
kaldvel	काल्डवेल	काल्डवेल
kaldwell	काल्डवेल	कललडवेल
kaav	काव	काव
kav	काव	काव
kaasht	काश्त	काष्ट
kasht	काश्त	कष्ट
kasim	कासिम	कसीम
qasim	कासिम	कसीम
kasimabad	कासिमाबाद	कासिमाबाद
kiya	किया	किया
kiliyan	किलियन	किलियां
killat	किल्लत	किल्ट
killi	किल्ली	किल्ली
kisaani	किसानी	किसानी
kisani	किसानी	किसनी
kisanon	किसानों	किसनों
keede	कीड़े	कीडे
kide	कीड़े	काइड
keynote	कीनोट	केनोट
kinote	कीनोट	किनोट
kiratpur	कीरतपुर	कीरतपुर
kundal	कुंडल	कुंदल
kundaliya	कुंडलियाँ	कुंदललयय
kundaliyan	कुंडलियाँ	कुंदलियां
kutta	कुत्ता	कुटता
kuposhit	कुपोषित	कुपोषित
kumau	कुमाऊ	कुमा
kumavat	कुमावत	कुमावत
kumawat	कुमावत	कुमावत
kural	कुराल	कुरल
kurmi	कुर्मी	कुर्मी
kursiyon	कुर्सियों	कुर्सियों
kush	कुश	कुश
kushaan	कुषाण	कुषाण
kushan	कुषाण	कुशन
kusumalataa	कुसुमलता	कुसूमलता
kusumalta	कुसुमलता	कुसूमलता
kusumlata	कुसुमलता	कुसूलता
koot	कूट	कूट
kut	कूट	कूट
kritika	कृतिका	कृतिका
kpo	केपीओ	कपपोओ
canterbari	कैंटरबरी	कैंटरबररी
canterbury	कैंटरबरी	कैंटरबरी
candidate	कैंडिडेट	कैंदेडत
katrina	कैटरीना	कैटरीना
caitlyn	कैटलिन	कैटलिन
cateline	कैटलिन	कैटललनन
catlin	कैटलिन	कैटलिन
cadmium	कैडमियम	कैडमिमम
catholic	कैथोलिक	कैथोलिक
catholicon	कैथोलिकों	कैथललिोो
kaetholikon	कैथोलिकों	कैथिलोकों
capacitor	कैपेसिटर	कैप्केटर
carat	कैरेट	कैरेट
cavity	कैविटी	केविटी
cavalry	कैवेलरी	केवररी
kaivelari	कैवेलरी	कैवेलररी
complex	कॉम्प्लेक्स	कंप्ल््स
kocchi	कोच्चि	कोचची
kochi	कोच्चि	कोची
corridor	कोरिडोर	कोर्डर
corolla	कोरोला	कोरलला
korola	कोरोला	कोरोला
caolan	कोलन	कालन
colan	कोलन	कॉलन
colon	कोलन	कॉलों
calling	कोलिंग	कॉलिंग
koling	कोलिंग	कोलिंग
colorado	कोलोराडो	कलोर्डो
kolorado	कोलोराडो	कोलरर्डो
kaushal	कौशल	कौशल
kaushalata	कौशलता	कौशलता
kaushalta	कौशलता	कौशलता
kaushambi	कौशाम्बी	कौशंबी
cute	क्यूट	कूट
quete	क्यूट	क्वेट
cube	क्यूब	क्यूब
cubeck	क्यूबेक	कबबकक
quebec	क्यूबेक	क्यूबेक
cubes	क्यूब्स	कबबसस
krantiyon	क्रांतियों	क्णतणियों
cric	क्रिक	क्रिक
crick	क्रिक	क्रिक
cricket	क्रिकेट	क्रिक्ट
cricketer	क्रिकेटर	क्रिक्टर
cricketing	क्रिकेटिंग	क्रिक्टिंग
kriyayog	क्रियायोग	क्रियागग
christian	क्रिश्चयन	क्रिस्टियां
kruger	क्रूगर	क्राग
craig	क्रेग	क्राग
creg	क्रेग	क्रेग
cradle	क्रैडल	क्राडल
chrom	क्रोम	क्रोम
chrome	क्रोम	क्रोम
client	क्लांइट	क्लांट
clock	क्लाक	क्लॉक
clasen	क्लासें	क्लासन
classen	क्लासें	क्लासनन
classon	क्लासों	क्लासन
clay	क्ले	क्ला
claris	क्लेरिस	क्लेरिस
cleris	क्लेरिस	क्लरसस
clerys	क्लेरिस	क्लर्स
quantico	क्वांटिको	क्वांटिको
queens	क्वींस	क्विंस
kshitij	क्षितिज	क्षितिज
shitij	क्षितिज	शीतिज
kshin	क्षीण	क्षिन
shin	क्षीण	शिन
kshetron	क्षेत्रों	क्षेत्रों
shetron	क्षेत्रों	श्त्रों
khand	खंडा	खंड
khanda	खंडा	खंडा
khachakhach	खचाखच	खचाछच
khajarana	खजराना	खजजराा
khajraana	खजराना	खजराना
khajrana	खजराना	खजराना
khatakati	खटकती	खटकती
khatakti	खटकती	खटकती
kihatkati	खटकती	किहकतती
khattapan	खट्टापन	खट्टापन
khat	खत	खत
khani	खनि	खानी
khanik	खनिक	खानिक
khanikarm	खनिकर्म	खानिकररम
khanikarma	खनिकर्म	खानिक्रम
khanikarmi	खनिकर्म	खानिकररमी
khapat	खपत	खपत
khariya	खरिया	खररया
khalnayak	खलनायक	खललायक
khaaskar	ख़ासकर	खासकर
khaskar	ख़ासकर	खासरर
khaastaur	ख़ासतौर	खास्तर
khastaur	ख़ासतौर	खससतौ
khaibar	ख़ैबर	खाबर
khyber	ख़ैबर	खाबरब
khaein	खाएं	खाएं
khaen	खाएं	खाएं
khayen	खाएं	खायंं
khaate	खाते	खाते
khaatey	खाते	खाते
khate	खाते	खाते
khal	खाल	खाल
khinchakar	खिंचकर	खिंचकर
khinchkar	खिंचकर	खींचकर
khilana	खिलाना	खिलना
khinchkar	खींचकर	खींचकर
khuda	खुदा	खुड़
khudai	खुदाई	खुड़ई
khurapka	खुरपका	खुरपका
khurpaka	खुरपका	खुरपका
khurasan	खुरासान	खुरसान
khushiyan	खुशियां	खुशियां
khene	खेने	खेने
khaini	खैनी	खैनी
khairati	खैराती	खैरती
khoikhoi	खोईखोई	खोहोई
khoya	खोया	खोया
gangrel	गंगरेल	गंग्रलल
gangaajal	गंगाजल	गंगाजल
gangajal	गंगाजल	गंगााल
gandaki	गंडकी	गंदककी
gandki	गंडकी	गंदकक
gandh	गंध	गंंध
gandha	गंध	गंंध
gae	गए	गा
gaye	गए	गाए
gajara	गजरा	गजरा
gajra	गजरा	गजरा
gadkar	गडकर	गड़कर
ganapati	गणपति	गणपती
ganpati	गणपति	गंपती
gatisheel	गतिशील	गतितिल
gatishil	गतिशील	गतितिश
gatishilata	गतिशीलता	गतिशिलिता
gadadhar	गदाधर	गड़धार
gammat	गम्मत	गममात
gaya	गया	गाया
garibi	गरीबी	गरिबी
garjana	गर्जना	गरजजना
galgand	गलगंड	गललंंड
gahmagahmi	गहमागहमी	गहममाममम
gemhagehmi	गहमागहमी	जेमानेममी
ganguly	गांगुली	गंगुलीय
gaanth	गांठ	गांथ
ganth	गांठ	गंथ
gaanthe	गांठे	गांठे
ganthe	गांठे	गांठे
ganthen	गांठें	गंठें
ganthon	गांठों	गंठों
gaen	गाएं	गाएं
gayen	गाएं	गाएं
gazi	गाज़ी	गाज़
gajipur	गाजीपुर	गजजपपर
gazipur	गाजीपुर	गजजजपपर
gayatri	गायत्री	गायत्र
gayitri	गायत्री	गायत्री
gaytri	गायत्री	गात्री
gidgidate	गिड़गिड़ाते	गिडगडिइट
ginate	गिनते	गिनते
ginte	गिनते	गिंटे
girkar	गिरकर	गिरकर
girijaghar	गिरजाघर	गिरिजनर
girjaghar	गिरजाघर	गिरजजनर
girijagharon	गिरजाघरों	गिरजजामोंों
girjagharon	गिरजाघरों	गिरजाजाोों
girati	गिरती	गिरती
girti	गिरती	गिरती
girish	गिरीश	गिरिश
guan	गुआन	गुआन
gujar	गुजार	गुजर
gujarata	गुजारता	गुजरात
gujarta	गुजारता	गुजरतत
gujarate	गुजारते	गुजरते
gujarte	गुजारते	गुजरते
gujarana	गुजारना	गुजराना
gujarna	गुजारना	गुजरान
gujara	गुजारा	गुजरा
gujare	गुजारे	गुजरेे
gutta	गुट्टा	गुट्ता
gthalidar	गुठलीदार	गलिलदार
guthalidar	गुठलीदार	गुथलिदार
gudna	गुदना	गुड़ा
gumaan	गुमान	गुमान
guman	गुमान	गुमान
gulshan	गुलशन	गुलशन
gunga	गूंगा	गुंगा
grihnagar	गृहनगर	गृहनगर
gruhnagar	गृहनगर	गृहनाग
galaxion	गैलेक्सियों	गललेक्सों
galaxiyon	गैलेक्सियों	गललकिियों
galaxyon	गैलेक्सियों	गलला््यों
gochar	गोचर	गोचर
gouchar	गोचर	गौचार
godara	गोदारा	गोदरर
gopichand	गोपीचंद	गोपीचंद
gomake	गोमके	गोमके
gomke	गोमके	गोमकक
goel	गोयल	गोल
goyal	गोयल	गोयल
gosvaami	गोस्वामी	गोस्वामी
gosvami	गोस्वामी	गोस्वामी
goswami	गोस्वामी	गोस्वामी
gaumukh	गौमुख	गौमुख
gomukh	गौमुख	गोमुख
gaumutr	गौमूत्र	गौमूत्र
gaumutra	गौमूत्र	गौमूत्र
gowmutra	गौमूत्र	गौमूत्र
granthiyaan	ग्रंथियां	ग्राणियां
granthiyan	ग्रंथियां	ग्रंथियां
grandhiyon	ग्रंथियों	ग्रांियों
granthiyon	ग्रंथियों	ग्राथियों
greest	ग्रीस्ट	ग्रीस्ट
greist	ग्रीस्ट	ग्रीस्ट
grist	ग्रीस्ट	ग्रिस्ट
greg	ग्रेग	ज्रेग
granite	ग्रेनाइट	ग्रेनाइट
grenite	ग्रेनाइट	ग्रेनेट
grandson	ग्रैंडसन	ग्रांडसन
gross	ग्रॉस	ग्रॉस
ghataatop	घटाटोप	घटाटो
ghatatop	घटाटोप	घटटटो
ghataayaa	घटाया	घटाया
ghataya	घटाया	घटाया
ghanakar	घनाकार	घनकक
ghabrahat	घबराहट	घबराहा
ghasi	घासी	घसी
ghisai	घिसाई	घिसाई
ghisi	घिसी	घिसी
ghise	घिसे	घीसे
ghumakkadi	घुमक्कड़ी	घुमक्कादी
ghumakkdi	घुमक्कड़ी	घुमक्कीी
ghumakkadon	घुमक्कड़ों	घुमककराों
ghumakkaron	घुमक्कड़ों	घुमकककरों
ghumakkdon	घुमक्कड़ों	घुमककक्ं
ghummakkadon	घुमक्कड़ों	घूममाक्डोों
ghumaan	घुमाण	घुमाण
ghuman	घुमाण	घुमाण
ghoonsa	घूंसा	घूंसा
ghunsa	घूंसा	घुंसा
ghongha	घोंघा	घोंघा
ghontane	घोंटने	घोंटने
ghontne	घोंटने	घोंटने
ghot	घोट	घोट
ghodi	घोड़ी	घोड़ी
ghost	घोस्ट	घोस्ट
changul	चंगुल	चंगुल
chand	चंद	चां
chandan	चंदन	चंदन
chandana	चंदन	चंंना
chandu	चंदू	चंदू
chandon	चंदों	चंदोंं
chandrabali	चंद्रबली	चंद्रबलली
chandramaon	चंद्रमाओं	चंद्रमाओं
chakatte	चकत्ते	चकतते
chaktte	चकत्ते	चक्ते
chakkar	चक्कर	चक्कर
chkkar	चक्कर	चकककर
chakshu	चक्षु	चक्षु
chatagaon	चटगांव	चटााओं
chatgaon	चटगांव	चटगाओं
chadhane	चढ़ने	चढ़ाने
chadhne	चढ़ने	चढ़ने
chaturdik	चतुर्दिक	चतुर्दिक
chatunshkoniy	चतुष्कोणीय	चतुनसककिीय
chatushkoniy	चतुष्कोणीय	चतुष्कोणीय
chatushkoniya	चतुष्कोणीय	चतुट्ककिय
channa	चन्ना	चनना
chabate	चबाते	चबाेे
chabutare	चबूतरे	चबूतरे
chabutre	चबूतरे	चबूत्र
chamakna	चमकना	चमकाा
chamkana	चमकना	चमकाना
charas	चरस	चारस
charit	चरित	चरिि
charcha	चर्चा	चर्चा
churcha	चर्चा	चुरचा
charchaon	चर्चाओं	चर्चाओं
chalenge	चलेंगे	चलेंगे
chlenge	चलेंगे	क्लेंगे
chahunaur	चहुंओर	चाहुनर
chahunor	चहुंओर	चाहूनर
chanval	चांवल	चाववल
chanwal	चांवल	चाववल
chachaji	चाचाजी	चचाजी
chadar	चादर	चड़र
chadaron	चादरों	चड़रों
chadron	चादरों	चद्रों
chan	चान	चा
chanan	चानन	चनन
chaplusi	चापलूसी	चपलुसी
chayal	चायल	चययल
char	चार	चा
charon	चारों	चरों
charge	चार्ज	चारग
chart	चार्ट	चर्त
charton	चार्टों	चरततो
charts	चार्ट्स	चार्टसस
chaalit	चालित	चालित
chalit	चालित	चलीत
chikitsak	चिकित्सक	चिकित्सक
chikitsakon	चिकित्सकों	चिकित्सकों
chikhali	चिखली	चिखली
chiththi	चिट्ठी	चित्ठी
chitthi	चिट्ठी	चित्ठी
chithhi	चिठ्ठी	चिठी
chiththi	चिठ्ठी	चित्ठी
chitthi	चिठ्ठी	चित्ठी
chidchidapan	चिडचिडापन	चिडचिडापन
chidchidapan	चिड़चिड़ापन	चिड़चिीपपन
chidhate	चिढ़ते	चिढ़ते
chidhte	चिढ़ते	चिढ़े
chithrkar	चित्रकार	चित्रका
chitrkar	चित्रकार	चित्रकार
chipakane	चिपकने	चिपकाेे
chipakne	चिपकने	चिपकने
chipkane	चिपकने	चिपकाे
chimati	चिमटी	चिमती
chimti	चिमटी	चिमती
chillane	चिल्लाने	चिल्ने
chee	ची	चीई
chi	ची	ची
chuka	चुका	चुका
chune	चुने	चुने
chunar	चूनर	चुनर
changed	चेंज्ड	चैंगड
chetti	चेट्टी	चेट्ती
chennai	चेन्नई	चेनने
chero	चेरो	चेरो
chest	चेस्ट	चेस्ट
championship	चैंपियनशिप	चांपिपपपप
chor	चोर	चोर
choro	चोरों	चोरो
choron	चोरों	चोरों
chauk	चौक	चौक
chowk	चौक	चौक
chauka	चौका	चौका
chuka	चौका	चुका
chaukiyan	चौकियां	चौकियां
chauki	चौकी	चौकी
chaukhate	चौखटे	चौखते
chauguni	चौगुनी	चौगुनी
chauda	चौड़ा	चौड़ा
chaudah	चौड़ा	चौद़ा
chaudahavan	चौदहवां	चौद़वान
chaudhavan	चौदहवां	चौद़वन
chaudhawan	चौदहवां	चौद़वन
chaupati	चौपाटी	चौपती
chupaty	चौपाटी	चुपटीय
chaupal	चौपाल	चौपल
chaurai	चौरई	चौरईई
chausinga	चौसिंगा	चौसंगा
chausingha	चौसिंगा	चौउंंा
chhagan	छगन	छगन
chhabi	छबि	छाबी
chhalla	छल्ला	छला
chhallaa	छल्ला	छला
chhaviyaan	छवियाँ	छववियां
chhaviyan	छवियाँ	छववियां
chhavi	छवी	छावी
cheh	छह	चेह
chhah	छह	छा
chehon	छहों	चेहों
chhahon	छहों	छाहों
chhai	छाई	छाई
chhagla	छागला	छगला
chhajan	छाजन	छजन
chhaati	छाती	छाती
chhati	छाती	छटी
chhaapemaar	छापेमार	छापेमार
chhapemar	छापेमार	छपपेमर
chheenk	छींक	छींक
chhink	छींक	छींक
chink	छींक	छींक
chenkein	छींके	चेंकें
chhekein	छींके	छेकें
chhinke	छींके	छिंके
chhinky	छींके	छिंकी
chinke	छींके	छींके
chhudaane	छुडाने	छुड़ाने
chhudane	छुडाने	छुड़ने
chhupakar	छुपकर	छुपकर
chhupkar	छुपकर	छुपकर
chhupkr	छुपकर	छुपक्र
chhupata	छुपता	छुपता
chhupta	छुपता	छुपता
chhuptaa	छुपता	छुपता
chhura	छुरा	छुड़
chhuraa	छुरा	छुड़ा
chhuree	छुरी	छुऱी
chhuri	छुरी	छुऱ
chhure	छुरे	छुडे
chhootane	छूटने	छूटने
chhutane	छूटने	छुटने
chhutne	छूटने	छुटने
chheter	छेत्र	छेतर
chhetr	छेत्र	छेत्र
chhetter	छेत्र	छेत्टर
chhetri	छेत्री	छेत्री
chhetthari	छेत्री	छेत्ररी
chhetthri	छेत्री	छेत्रर
chai	छै	चाई
chhai	छै	छाई
chhe	छै	छे
jagaega	जगाएगा	जगागग
jagayega	जगाएगा	जगाेगा
jaghaega	जगाएगा	जगागगा
jgaayega	जगाएगा	जगाएगा
jgayegaa	जगाएगा	जगाएगा
jajaon	जजों	जजााओं
jajon	जजों	जाजों
jad	जड़	जा
jadd	जड़	जड़द
jaddit	जड़ित	जड़ीत
jadeite	जड़ित	जड़ेते
jadet	जड़ित	जड़ेत
jadit	जड़ित	जा़ित
jadein	जड़ें	जड़ें
jaden	जड़ें	जा़ें
jatara	जतरा	जटार
jatra	जतरा	जातर
jataati	जताती	जटाती
jatatee	जताती	जटाती
jatati	जताती	जटाती
janagananaa	जनगणना	जननानना
janaganna	जनगणना	जननगना
jangadnaa	जनगणना	जंगााना
janganana	जनगणना	जंगानना
janganna	जनगणना	जागननना
janajagran	जनजागरण	जनजजग्र
janjaagran	जनजागरण	जनजाग्र
janjagran	जनजागरण	जनजागरण
january	जनवरी	जनुूरी
janahaani	जनहानि	जनहानि
janahani	जनहानि	जनहानी
janhaani	जनहानि	जनहहनी
janhani	जनहानि	जनहहनी
jnhaani	जनहानि	जनहानी
jamaate	जमाती	जमाती
jamaati	जमाती	जमाती
jamati	जमाती	जमाती
jamaaya	जमाया	जमाया
jamaeya	जमाया	जमाया
jamaya	जमाया	जमाया
jamayaa	जमाया	जमाया
jamuai	जमुई	जमुआई
jamuei	जमुई	जमूए
jamui	जमुई	जमूई
jai	जय	जाई
jay	जय	जाय
jaidayal	जयदयाल	जैदाल
jayadayal	जयदयाल	जययदाल
jaydayal	जयदयाल	जययदाल
jaibaan	जयबाण	जाबनन
jaiban	जयबाण	जयबाण
jaybaan	जयबाण	जाबान
jayalalita	जयललिता	जयलललिता
jayalalitaa	जयललिता	जयललिता
jayalalithaa	जयललिता	जयलल्याा
jaylalita	जयललिता	जायललिता
jarakh	जरख	जरख
zarakh	जरख	जराख
jarda	जर्दा	जरददा
jardaa	जर्दा	जरदाा
zarda	जर्दा	जरदाा
jalagati	जलगति	जलागती
jalgati	जलगति	जलतती
jalgti	जलगति	जलतती
jalte	जलते	जलते
jalbharav	जलभराव	जलभराव
jalbhraav	जलभराव	जलभावव
jalbhrav	जलभराव	जलभभरव
jalvaayu	जलवायु	जलवायु
jalvayu	जलवायु	जलवायु
jalesar	जलेसर	जलेसर
jasmeet	जसमीत	जसमीत
jasmit	जसमीत	जससमत
jassee	जस्सी	जससी
jassi	जस्सी	जससी
jamaanaa	ज़माना	जमाना
jamana	ज़माना	जमाना
zamaanaa	ज़माना	जमानना
zamana	ज़माना	जममनना
jaljale	ज़लज़ले	जलालेे
zalzale	ज़लज़ले	जलालेेे
zee	ज़ी	जी
jubaan	ज़ुबान	जुबान
juban	ज़ुबान	जुबान
zuban	ज़ुबान	ज़ुबान
jaanch	जाँच	जांच
jaaunch	जाँच	जौनच
janch	जाँच	जांच
jaunch	जाँच	जौंच
jaagriti	जागृति	जागातति
jagriti	जागृति	जगगीती
jagruti	जागृति	जगगरत
jajamau	जाजमऊ	जाजमऊ
jajmau	जाजमऊ	जाजमऊ
jajmauu	जाजमऊ	जजमाऊ
jaat	जात	जात
jat	जात	जा
jaatak	जातक	जातक
jatak	जातक	जटक
jaatakon	जातकों	जातकों
jaatkon	जातकों	जातकों
jatakon	जातकों	जटककों
jaatiyon	जातियों	जातियों
jatiyon	जातियों	जातियों
jaankaaron	जानकारों	जानकररों
jaankaron	जानकारों	जानकरों
jankaron	जानकारों	जनकारों
jaanam	जानम	जानम
janam	जानम	जनमम
jaayke	जायके	जायके
jayke	जायके	जायक
jaawar	जावर	जावर
zawar	जावर	जववर
jing	जिंग	जिंग
gin	जिन	गिन
jeen	जिन	जीन
jin	जिन	जिन
ginee	जिनी	गिनी
jinee	जिनी	जीनी
jini	जिनी	जीनी
geneva	जिनीवा	जेनेवा
jeneva	जिनीवा	जेनेवा
jiniva	जिनीवा	जिनिवा
gypsy	जिप्सी	जिप्सी
jimme	जिम्मे	जिम्मे
jiya	जिया	जिया
gic	जीआईसी	गीआसस
gr	जीआर	गीआरआ
gm	जीएम	जीएम
gsm	जीएसएम	जीएमएम
gtod	जीतोड़	गीटडड
gtor	जीतोड़	गीटर
jeetod	जीतोड़	जीतोड़
jitod	जीतोड़	जितोड़
jean	जीन	जीन
jeen	जीन	जीन
jin	जीन	जिन
jeenon	जीनों	जीनों
jinon	जीनों	जिनों
jeepney	जीपनी	जीपने
jipani	जीपनी	जीपनी
jeeyo	जीयो	जीयो
jio	जीयो	जिय
jiyo	जीयो	जियो
jeera	जीरा	जीरा
jira	जीरा	जीरा
jeevant	जीवंत	जीवंत
jivant	जीवंत	जीवंत
jeevan	जीवन	जीवन
jeewan	जीवन	जीवान
jivan	जीवन	जीवन
jiwan	जीवन	जीवन
jeevanshaili	जीवनशैली	जीवनशशली
jivanshaili	जीवनशैली	जीवनशशली
jeevniyaan	जीवनियां	जीवनियां
jivaniya	जीवनियां	जीवनीय
jivaniyaan	जीवनियां	जीवनियां
jivaniyan	जीवनियां	जीवनियां
jeevraaj	जीवराज	जीवराज
jivraj	जीवराज	जीवराज
jua	जुए	जूआ
jue	जुए	जू
juye	जुए	जुए
jutee	जुटी	जूटी
juti	जुटी	जूटी
judaai	जुड़ाई	जुड़ईई
judae	जुड़ाई	जुड़ई
judai	जुड़ाई	जुड़ई
judaai	जुदाई	जुड़ईई
judai	जुदाई	जुड़ई
junoon	जुनून	जूनूं
junun	जुनून	जूनून
junooni	जुनूनी	जुनुनी
jununi	जुनूनी	जुनुनी
jubair	जुबेर	ज़बयर
juber	जुबेर	ज़ूबर
zubair	जुबेर	ज़बैर
juraab	जुराब	जुराब
jurab	जुराब	जुरब
julaahon	जुलाहों	जुलाहों
julahon	जुलाहों	जुलाहों
julmon	जुल्मों	जुलममो
zulmon	जुल्मों	जुलममों
jood	जूड	जूड
jud	जूड	जुड
junagadh	जूनागढ	जुनागढ़
junagarh	जूनागढ	जूनागढ
junior	जूनियर	जुनियर
jealous	जूलूस	जीयोस
juloos	जूलूस	जुलूस
julus	जूलूस	जूलूस
jetha	जेठा	जेठा
jenner	जेनर	जेने
generic	जेनरिक	जेनेरिक
jenrick	जेनरिक	जेनििक
generat	जेनरेट	जेनेट
generate	जेनरेट	जेनेेट
jenee	जेनी	जेनी
jenni	जेनी	जेनी
jenny	जेनी	जेनी
james	जेम्स	जमेस
jeremy	जेरेमी	जेरेमी
gerome	जेरोम	जेरोमम
jerome	जेरोम	जेरोम
jacks	जैक्स	जैक्स
jain	जैन	जाएं
gene	जैने	जेने
jaine	जैने	जैने
jaino	जैनों	जैनो
jainon	जैनों	जैनों
jerry	जैरी	जेरी
jasper	जैस्पर	जैस्पर
jogging	जॉगिंग	जोगिंग
johnson	जॉनसन	जॉन्नन
jobs	जॉब्स	जॉब्स
jockey	जोकि	जोकी
joki	जोकि	जोकी
jokhim	जोखिम	जोखिम
joddta	जोड़ता	जोड़ता
jodta	जोड़ता	जोड़त
jorhta	जोड़ता	जोड़ता
jodiyon	जोड़ियों	जोड़यों
jodo	जोड़ो	जोड़ो
jaun	जौं	जौं
gyatavya	ज्ञातव्य	ज्ञातव्य
gyatvy	ज्ञातव्य	ज्ञात््
gyapit	ज्ञापित	ज्ञापित
jyotiba	ज्योतिबा	ज्योतिबा
joint	ज्वाइंट	जॉइंट
jvar	ज्वार	ज्वर
jwar	ज्वार	ज्वार
jvaaron	ज्वारों	जवारों
jvaron	ज्वारों	ज्वरों
jwaron	ज्वारों	ज्वारों
jewellers	ज्वेलर्स	ज्वेलर्स
jh	झ	झे
jha	झ	झा
jhalakti	झलकती	झलकती
jhalkati	झलकती	झलकती
jhalla	झल्ला	झलला
jhankana	झांकना	झंकाना
jhankna	झांकना	झंकाा
jheel	झील	झील
jhil	झील	झिल
jheelon	झीलों	झीलों
jhilon	झीलों	झिलों
jhuthala	झुठला	झुठला
jhuthla	झुठला	झुठला
jhuthalane	झुठलाने	झुठलाने
jhuthlane	झुठलाने	झुठलाे
tankaar	टंकार	टंकर
tankar	टंकार	टंकर
takara	टकरा	टकरा
takra	टकरा	टकरा
takaraon	टकरावों	टकराओं
takravon	टकरावों	टकरावों
tapakti	टपकती	तपपकत
tapkati	टपकती	तपकती
time	टाइम	टाइम
timer	टाइमर	टाइमर
taoo	टाऊ	ताऊ
tau	टाऊ	ताऊ
tapoowo	टापुओं	टपपोो
tapuon	टापुओं	तपपुओं
tapuwo	टापुओं	टापुओं
tied	टायर्ड	टाइड
tired	टायर्ड	टारेड
tyred	टायर्ड	टायर्ड
tarch	टार्च	तर्
torch	टार्च	टॉर्च
tik	टिक	टीक
teap	टिप	टीप
tip	टिप	टीप
tippanikar	टिप्पणीकार	टिप्पनिकार
tippnikar	टिप्पणीकार	टिप्पनकका
tivolee	टिवोली	तिइोल
tivoli	टिवोली	तिइोली
teekamgarh	टीकमगढ़	टीकंगगढ
tikamgarh	टीकमगढ़	टिकागगढ़
teekon	टीकों	टीकों
tikon	टीकों	टिकों
two	टु	ट्वो
tension	टेंशन	टेंसियो
tenis	टेनिस	टेनिस
tennis	टेनिस	टेनििस
taste	टेस्ट	टासते
test	टेस्ट	टेस्ट
tasting	टेस्टिंग	ता््टिंग
testing	टेस्टिंग	टेस्टिंग
tainin	टैनिन	तैनीन
tenin	टैनिन	टेनिन
tanish	टैनिस	तनीीश
tennis	टैनिस	टेनििस
taboo	टैबू	तबूू
taiboo	टैबू	टैबबब
taobao	टैबू	ताबोओ
tonic	टॉनिक	टॉनिक
tonga	टोंगा	टोंगा
toka	टोका	टोका
tuesday	ट्यूजडे	टुयूडे
tuning	ट्यूनिंग	ट्निंग
tuberculosis	ट्यूबरक्यूलोसिस	ट्बब्््रेनस
tuberkyulosis	ट्यूबरक्यूलोसिस	टुबब्््रननिस
truck	ट्रक	ट्रकक
trangistor	ट्रांजिस्टर	ट्रांगिट्टर
tranjister	ट्रांजिस्टर	ट्रांजिटट्र
transistor	ट्रांजिस्टर	ट्रांसिट्टर
transfer	ट्रान्सफर	ट्रांसरर
tribunal	ट्रिब्युनल	ट्रिब्लल
tribunal	ट्रिब्यूनल	ट्रिब्लल
trubyunal	ट्रिब्यूनल	ट्रबजललल
truth	ट्रुथ	तृथ
tuth	ट्रुथ	तूठ
traded	ट्रेडेड	ट्रेड्ड
trabal	ट्रेबल	ट्रेब
trebal	ट्रेबल	ट्रेबल
trouble	ट्रेबल	ट्रेबल
traip	ट्रैप	ट्रैप
trap	ट्रैप	ट्रैप
trot	ट्रॉट	ट्रॉट
trott	ट्रॉट	ट्रॉट
thakkar	ठक्कर	ठक्कर
thakkr	ठक्कर	ठक्क
thaharne	ठहरने	ठहराने
thahrane	ठहरने	ठहराने
theharne	ठहरने	ठहराे
thikane	ठिकाने	ठिकाेे
thumari	ठुमरी	थुमाी
thumri	ठुमरी	थुमरी
theinga	ठेंगा	ठेंगा
thenga	ठेंगा	ठेंगा
thengaa	ठेंगा	ठेंगा
daglas	डगलस	डगलस
douglas	डगलस	डोगलस
dabhara	डभरा	दभारा
dabhra	डभरा	दभभर
dabhoi	डभोई	डभोई
dam	डम	डम
dum	डम	डूम
darate	डराते	दराते
daratey	डराते	दराते
daravani	डरावनी	दरवानी
darawani	डरावनी	दराानी
dravani	डरावनी	डरावनी
down	डाउन	डान
daak	डाक	डाक
dak	डाक	डक
daka	डाका	डकक
dabi	डाबी	डबी
dabolim	डाबोलिम	डबोलिम
dinosaur	डायनासोर	डिनोसर
diaries	डायरीज	डायरिस
dit	डिट	डिट
depthiriya	डिप्थीरिया	डिप्थीरिया
diphtheria	डिप्थीरिया	दिप्तरिर
de	डीई	डे
dealership	डीलरशिप	डिल्््प
dvc	डीवीसी	डीवीसी
dubaana	डुबाना	दुबाना
dubana	डुबाना	दूबना
dubona	डुबोना	डूबोना
dulne	डुलने	डुलने
doonarpur	डूंगरपुर	दूनरपपर
doongarpur	डूंगरपुर	डूनगपपुर
dungarpur	डूंगरपुर	डूंगपरुर
dungerpur	डूंगरपुर	डंंरपपर
dubana	डूबना	दूबना
dubna	डूबना	डूबना
dangerous	डेंजरस	डांगररस
daisy	डेजी	दैसी
dazy	डेजी	डाज
deji	डेजी	डेजी
deputy	डेप्युटी	डिप्टी
davidson	डेविडसन	डवविडसों
devidson	डेविडसन	डेविइसनो
davey	डेवी	डेवी
devi	डेवी	डेवी
dewey	डेवी	डेवे
destination	डेस्टिनेशन	डिस्टेशनशन
datson	डैटसन	डत्टों
datsun	डैटसन	दत्सुन
daddy	डैडी	दड्दी
dark	डॉर्क	डर्क
dork	डॉर्क	डॉर्क
dose	डोज	डोस
domenic	डोमेनिक	डोमेनिक
doranda	डोरंडा	दोरंडा
dolane	डोलने	डोलने
dolne	डोलने	डोलने
dual	ड्युअल	ड्युअल
duak	ड्यूक	ड्यूक
duke	ड्यूक	डुके
drame	ड्रामे	ड्रामे
dramen	ड्रामे	ड्रामे
drager	ड्रेजर	ड्रेगर
dredger	ड्रेजर	ड्रेजर
dreijer	ड्रेजर	ड्रेइर
dhakaal	ढकाल	धकाल
dhakal	ढकाल	ढकाल
dhakkal	ढकाल	धक्कल
dhkal	ढकाल	ढका
dhale	ढले	ढाले
dhoondh	ढूंढ	ढूंढ
dhundh	ढूंढ	ढूंध
dhoondhata	ढूंढता	ढूंढता
dhundhata	ढूंढता	धूंढता
dhundhta	ढूंढता	ढूंढता
dhoondhi	ढूंढी	ढूंढी
dhundhi	ढूंढी	ढूंढी
tanjavur	तंजावुर	तंजावूर
thanjavur	तंजावुर	थंजावूर
tantr	तंत्र	तांतर
tantra	तंत्र	तंत्र
tantrikao	तंत्रिकाओं	तंत्रिकां
tantrikaon	तंत्रिकाओं	तंत्रिकाओं
tantro	तंत्रों	टंंटरो
tantron	तंत्रों	तंंतरों
tagade	तगड़े	तगड़े
tagde	तगड़े	टगडेे
tadipaar	तड़ीपार	तड़ीपा
tadipar	तड़ीपार	तड़ीप
tani	तनी	तानी
tapan	तपन	तपन
tarafa	तरफा	तरफा
tarfa	तरफा	तरका
tarabganj	तरबगंज	तरबबंगज
taras	तरस	तारस
taraash	तराश	ताराश
tarash	तराश	तराश
tarashay	तराशे	तरराश
tarashe	तराशे	तररश
tareeko	तरीको	तरीकको
tariko	तरीको	तारिको
tark	तर्क	टार्क
tarkvaad	तर्कवाद	तर्कवाद
tarkvad	तर्कवाद	तरक्वाद
tarkwaad	तर्कवाद	तरकावाद
tarko	तर्कों	टरको
tarkon	तर्कों	तरककं
talabgaar	तलबगार	तलाबबर
talabgar	तलबगार	तललबरर
talbagaar	तलबगार	तललबरर
talbagar	तलबगार	तललबरर
talawe	तलवे	तलवे
talve	तलवे	तलवे
talawon	तलवों	तललाों
talvon	तलवों	तलववों
tahakhana	तहखाना	तहखाा
tahkhaana	तहखाना	तहखाना
tahkhana	तहखाना	तहखाा
taantaa	तांता	तांता
tanta	तांता	तांता
tambe	तांबे	टांबे
tanbe	तांबे	टांब
taaja	ताजा	ताजा
taajaa	ताजा	ताजा
taaza	ताजा	ताजा
taja	ताजा	ताज
taza	ताजा	ताज़
tansen	तानसेन	टांसे
taapmaanon	तापमानों	तापमााोों
tapmano	तापमानों	तप्मनों
tapmanon	तापमानों	तप्मानों
taapti	ताप्ती	तापती
tapti	ताप्ती	तप्ी
tarabai	ताराबाई	तरबाई
taseer	तासीर	तसीर
tasir	तासीर	तसीर
taahi	ताहि	ताही
tahi	ताहि	ताही
tikone	तिकोने	टिकोन
tirupati	तिरूपति	तिरपुती
tiwari	तिवारी	तिवारी
ti	ती	टीई
teer	तीर	तीर
tir	तीर	टीर
teeron	तीरों	टीरोन
tiron	तीरों	तीरों
tirthatan	तीर्थाटन	तीर्थाान
tungnath	तुंगनाथ	तुंगाथथ
tughlaq	तुगलक	तुललकक
tuglak	तुगलक	तुगलक
tughlakabad	तुगलकाबाद	तुगलकाबाद
tughlaqabad	तुगलकाबाद	तुलगाबबाड
tuglakabad	तुगलकाबाद	तुगलकबबा़
tugalaki	तुगलकी	तुगलकी
tugalki	तुगलकी	तुगलकी
tuglaki	तुगलकी	तुगलकी
tufail	तुफैल	टुफलल
tejaji	तेजाजी	तेजाजी
teji	तेजी	तेजी
tel	तेल	टेल
telon	तेलों	टेलों
to	तो	टॉ
toh	तो	तोह
taul	तौल	ताल
tyohaar	त्यौहार	त्यौहार
tyohar	त्यौहार	त्योहरर
tyoihar	त्यौहार	त्योहार
tyauharon	त्यौहारों	त्यौहारों
tyoharon	त्यौहारों	त्योहारों
tyoiharon	त्यौहारों	ट्योहारों
trijata	त्रिजटा	त्रिजटा
trijta	त्रिजटा	त्रिजता
triya	त्रिया	त्रिया
tremasik	त्रैमासिक	ट्रेमिसिक
trimasik	त्रैमासिक	ट्रिमासिक
tse	त्से	त्से
thaki	थकी	ठकी
thki	थकी	थकी
tharti	थर्टी	ठरती
thirty	थर्टी	थर्टी
thane	थाणे	थाणे
thaanvi	थानवी	थानवी
thanvi	थानवी	थावी
theateron	थिएटरों	थीटरों
theatron	थिएटरों	थिएटरों
theaters	थिएटर्स	थीटर्स
theater	थियेटर	ठीटर
theatre	थियेटर	ठीटरे
theateron	थियेटरों	थीटरों
theatron	थियेटरों	ठीत्रों
thitron	थियेटरों	ठित्रों
theaters	थियेटर्स	थीटर्स
theatrs	थियेटर्स	थियेटर्स
thiyeters	थियेटर्स	थाइट््स
thirake	थिरके	थिरके
thirke	थिरके	थिरक
thief	थीफ	थीफ
then	थेन	थें
theni	थेनी	ठेनी
thailee	थैली	थाली
thaili	थैली	थैली
thaile	थैले	थाले
dang	दंग	डांग
danga	दंगा	डंंग
dangon	दंगों	डांगों
dampati	दंपति	दंमपती
danpati	दंपति	दंपतत
dampatiyon	दंपतियों	डमपततियों
dampattiyon	दंपतियों	दमपतततियों
danptiyon	दंपतियों	डंपतियों
dadreva	ददरेवा	दद्रेव
dadrewa	ददरेवा	दड्ेवा
damoh	दमोह	दमोह
dardara	दरदरा	दर्दरा
dardraa	दरदरा	दर्दरा
durdhara	दरदरा	दूरदरा
darmiyaan	दरमियान	दरमियां
darmiyan	दरमियान	दरमियां
darjano	दर्जनों	दर्जनों
darjanon	दर्जनों	दर्जनों
darp	दर्प	दर्प
darra	दर्रा	दर्रा
dalbadal	दलबदल	दललबाल
dalbadl	दलबदल	डललबबल
dali	दली	दली
dastaanaa	दस्ताना	दस्ताना
dastana	दस्ताना	दस्तान
dastavej	दस्तावेज	दस्तावजज
dahan	दहन	दहन
dahal	दहल	दहाल
da	दा	ड
daakhil	दाखिल	दाखिल
dakhil	दाखिल	दखखल
daakhile	दाखिले	दाखिले
dakhile	दाखिले	दाखिले
daataa	दाता	दाता
data	दाता	दाा
dadari	दादरी	दडदरी
daanshil	दानशील	दानशील
danshil	दानशील	दंशिल
daabholkar	दाभोलकर	दाभोककर
dabholkar	दाभोलकर	दबोलकक
damale	दामले	डमाले
damle	दामले	डमलल
dayitv	दायित्व	दाित्व
dayitva	दायित्व	दाित्व
dayitwa	दायित्व	दयित्व
dayitvon	दायित्वों	डयित्वों
dayityon	दायित्वों	डयित्यों
darul	दारूल	दारल
daav	दाव	दाव
daaw	दाव	दाव
dav	दाव	देव
daw	दाव	डे
daah	दाह	दाह
dah	दाह	दाह
dikhla	दिखला	दिखला
dikhlaa	दिखला	दिखला
dikhaaiye	दिखाइये	दिखाइए
dikhaiye	दिखाइये	दिखाएए
dikhaai	दिखाई	दिखाई
dikhai	दिखाई	दिखाई
dikhayi	दिखाई	दिखाई
dikhaaee	दिखाईं	दिखाई
dikhaai	दिखाईं	दिखाई
dikhaain	दिखाईं	दिखाएं
dikhaee	दिखाईं	दिखाई
dikhai	दिखाईं	दिखाई
dikhayin	दिखाईं	दिखाईए
dikhai	दिखायी	दिखायी
dikhayi	दिखायी	दिखाई
dikhaai	दिखार्इ	दिखाई
dikhae	दिखार्इ	दिखाए
dikhai	दिखार्इ	दिखाई
dikhayi	दिखार्इ	दिखाई
dita	दिता	दीता
ditaa	दिता	दिता
dinaank	दिनांक	दिनांक
dinank	दिनांक	डिनांक
dirham	दिरहम	दीर्ाम
dilaaye	दिलाये	दिलाए
dilaye	दिलाये	दिलाए
deewani	दिवानी	दीवानी
diwani	दिवानी	दिवानी
divy	दिव्य	डिवी
divya	दिव्य	दिव्य
divyata	दिव्यता	दिव्यता
divya	दिव्या	दिव्य
deepan	दीपन	दीपान
deepn	दीपन	डीपन
dipan	दीपन	दीपान
deepsingh	दीपसिंह	डीप्पिन
dipsingh	दीपसिंह	डिप्सिंह
deepika	दीपिका	दीपिका
dipika	दीपिका	डिपिका
deeya	दीया	दीया
diya	दीया	दिया
dukaanon	दुकानों	दुकानकों
dukanon	दुकानों	दूकानों
dukke	दुक्के	डकक्क
dukhan	दुखन	दुखन
dukhit	दुखित	दुखित
dukhiyon	दुखियों	दुखियों
dukhon	दुखों	दुखों
dubhashiyon	दुभाषियों	दुभाषियों
durgun	दुर्गुण	दुर्गुण
durghatna	दुर्घटना	दूर्घतना
durghtna	दुर्घटना	दूर्घतन
duneerti	दुर्नीति	दूनिरतति
durniti	दुर्नीति	दूर्णिति
durbhiksh	दुर्भिक्ष	दुर्भष्ष
duvidhaaen	दुविधाएं	दुविधाएं
duvidhaayein	दुविधाएं	दुविधाएं
duvidhaen	दुविधाएं	दुविधाएं
duwaidhaayein	दुविधाएं	दुविधाएं
dune	दूने	डूने
doordarshan	दूरदर्शन	दूरदर्षण
durdarshan	दूरदर्शन	दूरदर्षण
dradh	दृढ़	दृरध
dridh	दृढ़	दृद्ध
dekhoge	देखोगे	देखेगे
denevaali	देनेवाली	देनेवाली
denevali	देनेवाली	डेनेवाली
denewaali	देनेवाली	देनेवाली
denewali	देनेवाली	डेनेवाली
deonar	देवनार	डियनर
devnaar	देवनार	देवनार
devnar	देवनार	देवना
devaapur	देवापुर	देवापुर
devapur	देवापुर	देवपपुर
devi	देवी	डेवी
devisingh	देवीसिंह	डेविसिनह
devisinh	देवीसिंह	डेविसिहनन
deshkaal	देशकाल	देशककल
deshkal	देशकाल	देशकाल
deshke	देशके	देशके
desai	देसाई	देसाई
doge	दोगे	डोग
dvadash	द्वादश	द्वादश
dwaadas	द्वादश	द्वादस
dvivedi	द्विवेदी	द्विवेदी
dwivedi	द्विवेदी	द्विवेदी
dhande	धंधे	ढंडेे
dhandhe	धंधे	ढंंेे
dhndhe	धंधे	धंंेे
dhandhon	धंधों	धंंधों
dhandon	धंधों	धंडोों
dhakelte	धकेलते	ढकेलते
dhkelate	धकेलते	ढकेतते
dhatana	धटना	धटाना
dhatna	धटना	धटना
dhankuber	धनकुबेर	धनककुब
dhanadhany	धनधान्य	धनंधनयय
dhandhaanya	धनधान्य	धनधान्य
dhandhany	धनधान्य	ढंधानी
dhandhanya	धनधान्य	धनधान्य
dhamkaataa	धमकाता	धमकाता
dhamkata	धमकाता	धमकता
dhamm	धम्म	धम्म
dhamma	धम्मा	धम्म
dhammaa	धम्मा	धम्मा
dharmnath	धर्मनाथ	धर्मााथ
dharmraj	धर्मराज	धर्मााज
dharmesh	धर्मेश	धर्मेश
dhasmaanaa	धस्माना	धस्माा
dhasmana	धस्माना	धस्माना
dhaak	धाक	ढाक
dhak	धाक	ढकक
dhaaga	धागा	धागा
dhaagaa	धागा	धागा
dhaga	धागा	ढाग
dhaatuein	धातुएं	धातुएं
dhaatuyein	धातुएं	धातुयंं
dhtuen	धातुएं	धटततं
dhaarak	धारक	धारक
dharak	धारक	धरक
dhaari	धारी	धारी
dhari	धारी	धारी
dhuan	धुआं	धुआं
dhunaai	धुनाई	धुनाई
dhunai	धुनाई	धुनाई
dhuriya	धुरिया	धुरिया
dhuriyaa	धुरिया	धुरिया
dhuni	धूनी	धुनी
dhairyavaan	धैर्यवान	धैर्यवान
dhairyawan	धैर्यवान	धैर्यवान
dhiryavan	धैर्यवान	धीर्ययान
dhiryawaan	धैर्यवान	धीर्याान
dhokebaaj	धोखेबाज	धोकेबजज
dhokebaaz	धोखेबाज	धोकेबाज
dhokebaj	धोखेबाज	धोखेबाज
dhokebaz	धोखेबाज	धोकेबाज
dhokhebaaj	धोखेबाज	धोखेबाज
dhokhebaj	धोखेबाज	धोखेबाज
dhona	धोना	ढोना
dhonaa	धोना	ढोना
dhoraaji	धोराजी	धोराजी
dhoraji	धोराजी	धोरजी
dhoron	धोरों	धोरों
dhyeyavaadi	ध्येयवादी	ध्ययवाादी
dhyeywadi	ध्येयवादी	ध्येववादी
dyeyvadi	ध्येयवादी	डायेवादी
dhrupad	ध्रुपद	ध्रुपद
drupad	ध्रुपद	द्पुद़
nandanvan	नंदनवन	नंददंवा
nadsa	नक्सल	नडदसा
naksal	नक्सल	नक््ल
naxal	नक्सल	नक््लल
naksalavaad	नक्सलवाद	नक्काावदद
naksalwaad	नक्सलवाद	नक्काावदद
naksalwad	नक्सलवाद	नक्कलावदद
naxalvaaad	नक्सलवाद	नक्तवादाद
naxalwaad	नक्सलवाद	नक्तलावाद
naksaliyon	नक्सलियों	नक््लियों
naxaliyon	नक्सलियों	नक््यललययों
naksali	नक्सली	नक््ली
naxali	नक्सली	नक्लली
nagaada	नगाड़ा	नगाडा
nagaadaa	नगाड़ा	नगाडा
nagaaraa	नगाड़ा	नगाड़ा
nageene	नगीने	नगेने
nagine	नगीने	नगगने
najarandaaj	नजरंदाज	नज़रंदाज
najarandaaz	नजरंदाज	नज़रंदाज
nazarandaaj	नजरंदाज	नज़रंदाज
nazarandaaz	नजरंदाज	नज़रंदाज
nazarandaz	नजरंदाज	नज़रंदाज
najraane	नजराने	नजराने
nazraane	नजराने	नज़ानेे
najariyon	नजरियों	नज़ाियों
najriyon	नजरियों	नजरियों
najron	नजरों	नज़रो
najeeb	नजीब	नजीब
najib	नजीब	नाजबब
najibabaad	नजीबाबाद	नजीबाबाद
najibabad	नजीबाबाद	नजीबाबाद
najeem	नजीम	नजीम
najim	नजीम	नज़ि
nazeem	नजीम	नज़मम
nana	नना	नाना
nanaa	नना	नाा
nna	नना	ननएए
nanhe	नन्हें	नन्हे
nanhein	नन्हें	नन्हें
nabj	नब्ज़	नब्ज
nabja	नब्ज़	नब्ज़
nabz	नब्ज़	नब्ज
namkeen	नमकीन	नमकीीन
namkin	नमकीन	नमकीन
narnaari	नरनारी	नरनारी
narnari	नरनारी	नरनारी
narbhakshi	नरभक्षी	नर्भश्ष
naram	नरम	नरमम
narm	नरम	नर्म
narmi	नरमी	नर्मी
narsanhar	नरसंहार	नरसाहहर
narsanharon	नरसंहारों	नरसाहहरों
november	नवंबर	नावमबर
navketan	नवकेतन	नवकेता
navjaagaran	नवजागरण	नवजागरण
navjagran	नवजागरण	नवजजगररण
navdha	नवधा	नवधा
navvadhoo	नववधू	नववादूो
navvadhu	नववधू	नववादूु
nava	नवा	नवा
navaa	नवा	नवा
navate	नवाते	नवाते
navanagar	नवानगर	नवानगर
nawanagar	नवानगर	नवानगर
navya	नव्या	नवयय
naseem	नसीम	नसीम
nasim	नसीम	नसीम
nights	नाइट्रस	नाइट्स
nitrous	नाइट्रस	नाइट्रस
nineteez	नाइनटीज	निनेंीज
nineties	नाइनटीज	नाइनटीज
ninties	नाइनटीज	निंटीस
nau	नाऊ	ना
nauu	नाऊ	नौऊ
naakaam	नाकाम	नाकाम
nakam	नाकाम	नककम
naagrik	नागारिक	नागरिक
nagarik	नागारिक	नागरिक
nagrik	नागारिक	नागरिक
nagin	नागिन	नागी
nadep	नाडेप	नाेेप
nanak	नानक	नानक
nanavati	नानावती	नननावत
napane	नापने	नापने
napne	नापने	नपपने
napa	नापा	नपप
naam	नाम	नाम
naamdhari	नामधारी	नामभारी
namdhari	नामधारी	नममधारी
namankano	नामांकनों	नमनाककों
namankanon	नामांकनों	नमनाककोो
namavaliyon	नामावलियों	नममवालियों
naamo	नामो	नामो
namo	नामो	नममो
nayak	नायक	नायक
naraji	नाराजी	नाराजी
naraingarh	नारायणगढ़	नररेंग़
narayangadh	नारायणगढ़	नररानगगढ
narayangarh	नारायणगढ़	नरराणगग़
naasar	नासर	नासर
nahargadh	नाहरगढ	नहररगढ
nahargarh	नाहरगढ	नहररगग़
nikalegi	निकलेगी	निकालगग
nikalogi	निकलेगी	निकालगगी
nikaalani	निकालनी	निकालनी
nikaalni	निकालनी	निकालीन
nikalani	निकालनी	निकालीी
nikalni	निकालनी	निकाली
nicki	निकी	निकी
nicky	निकी	निकी
niki	निकी	निकी
niketan	निकेतन	निकेटन
nikhar	निखर	निखर
nikhari	निखरी	निखाी
nigar	निगर	निगर
nigger	निगर	नागगर
nichala	निचला	निचला
nichalaa	निचला	निचला
nichla	निचला	निचला
nitiyon	नितियों	नितियों
nitya	नित्या	नित्य
nityaa	नित्या	नित्य
nidhaan	निधान	निधान
nidhan	निधान	निधान
nipatara	निपटारा	निपतरर
niptaara	निपटारा	निपटारा
niptaaraa	निपटारा	निपटारा
niptara	निपटारा	निपटार
niyanta	नियंता	नियंता
niyantaa	नियंता	नियंता
niya	निया	निया
niyaa	निया	निया
nirdeshika	निर्देशिका	निर्देशिका
nirdeshikaa	निर्देशिका	निर्देशीय
nirdhaarit	निर्धारित	निर्धातत
nirdharit	निर्धारित	निर्धृतत
nirbaadh	निर्बाध	निर्भा
nirbadh	निर्बाध	निर्भध
niveshakartaa	निवेशकर्ता	निवेशकरतता
niveshkarta	निवेशकर्ता	निवेशक्तत
niveshkartaa	निवेशकर्ता	निवेशक्रता
nischal	निश्चल	निस्चल
nishchal	निश्चल	निश्ल
nishnaat	निष्णात	निश्नत
nishpaap	निष्पाप	निष्पप
nihalaani	निहलानी	निहालनी
nihlaani	निहलानी	निहालनी
nihlani	निहलानी	निहलनी
nihaalchand	निहालचंद	निहालचंद
nihalchand	निहालचंद	निहालचंद
neechaaee	नीचाई	नीचाई
nichaai	नीचाई	निचाई
neat	नीट	नीत
neet	नीट	नीत
neetiyon	नीतियों	नीतियों
nitiyon	नीतियों	नितियों
neelagaay	नीलगाय	नीलाे
nilgai	नीलगाय	निलगाई
neelaabh	नीलाभ	नीलाभ
nilaabh	नीलाभ	निलाभ
nilabh	नीलाभ	नीलाभ
nuskhe	नुस्खे	नुस्ेे
noon	नून	नून
nun	नून	नून
noobiyaa	नूबिया	नूबिया
nubiya	नूबिया	नुबिया
nrityashaili	नृत्यशैली	नृत्यशाली
nrutyashaili	नृत्यशैली	नृत्यशाली
nrityon	नृत्यों	नृत्यों
nrutyon	नृत्यों	नृत्यों
neco	नेको	नेको
neko	नेको	नेको
nectar	नेक्टर	नेक्टर
neg	नेग	नेग
nega	नेग	नेगा
networking	नेटवर्किग	नेट्र्किंग
neto	नेटो	नेटो
neta	नेता	नेता
nemo	नेमो	नेमो
nelsan	नेल्सन	नेलसनन
nelson	नेल्सन	नेल्सन
nations	नेशंस	नेशंस
nehara	नेहरा	नेहरा
nehra	नेहरा	नेहरा
naino	नैनो	नैनो
nano	नैनो	नानो
naivedh	नैवेद्य	नैवेद्य
naivegh	नैवेद्य	नैवे़
nevedya	नैवेद्य	नेवेद्य
nominate	नॉमिनेट	नोमिनेट
naukari	नोकरी	नोकरी
naukri	नोकरी	नौकरी
nokari	नोकरी	नोकरी
nokri	नोकरी	नोकरी
notes	नोट्स	नॉटेस
nora	नोरा	नोरा
nori	नोरी	नोरी
nauner	नौनेर	नौने
nauvahan	नौवहन	नौवहन
naushad	नौशाद	नौशाद
panchaang	पंचांग	पंचांग
panchang	पंचांग	पांचंग
punchang	पंचांग	पंचांग
punjab	पंजाब	पूंजब
punjabiyon	पंजाबियों	पुंजबियों
pantar	पंटर	पंंर
panter	पंटर	पैंटर
punter	पंटर	पुंटर
pakaayein	पकाएं	पकाईएं
pakaayen	पकाएं	पकाएं
pakaen	पकाएं	पकाएं
pakayen	पकाएं	पकाएं
pakaude	पकौड़े	पककड़े
pakshapat	पक्षपात	पक्षापत
pakshpaat	पक्षपात	पक्षपात
pakshpat	पक्षपात	पक्षपपत
pagabadha	पगबाधा	पगाब्ा
pagbadha	पगबाधा	पगबाधा
pagalaa	पगला	पगला
pagla	पगला	पगला
pachaataa	पचाता	पचाता
pachata	पचाता	पचाता
patakkar	पटककर	पत्कक
patkathaayein	पटकथाएं	पत्थाएं
patkathaein	पटकथाएं	पत्थाएं
patkathayen	पटकथाएं	पत्थाएं
patki	पटकी	पटकी
pataraani	पटरानी	पारानी
patrani	पटरानी	पत्रणी
patavaari	पटवारी	पताारी
patwari	पटवारी	पतवररी
pataakshep	पटाक्षेप	पतककशशप
patachep	पटाक्षेप	पाचचप
patakshep	पटाक्षेप	पक्ककेप
patiya	पटिया	पटीया
patiyaa	पटिया	पटिया
padaraunaa	पडरौना	पदारना
padrauna	पडरौना	पद्रणण
padega	पड़ेगा	पडेगा
padegaa	पड़ेगा	पडेेग
padha	पढ़ा	पढ़ा
padhaa	पढ़ा	पढ़ा
padhaataa	पढ़ाता	पढ़ता
padhata	पढ़ाता	पढ़ता
patili	पतीली	पटीली
padamawati	पदमावती	पदममववी
padmavati	पदमावती	पद्मावती
padmawati	पदमावती	पद्मावती
padadhikari	पदाधिकारी	पदाधिकारी
panapnaa	पनपना	पननपन
panpana	पनपना	पनपपन
panaamaa	पनामा	पनामा
panama	पनामा	पनमम
paneer	पनीर	पेनी
pammi	पम्मी	पम्मी
pammu	पम्मी	पम्मी
pummi	पम्मी	पमममम
pummy	पम्मी	पमम्य
pardesiyon	परदेसियों	परदेसियों
pardesi	परदेसी	परदेसी
parva	परवा	परवा
parvaa	परवा	परवा
parwa	परवा	परवा
parwaa	परवा	परवा
paraadheen	पराधीन	पराधीन
paraadhin	पराधीन	पराधीन
paradheen	पराधीन	पराधीन
paradhin	पराधीन	पराधीन
parikalpit	परिकल्पित	परिकापपित
parimal	परिमल	परिमल
parishad	परिषद	परिशाद
parishadiy	परिषदीय	परिशादयय
parishadiya	परिषदीय	परिशादिय
parishadon	परिषदों	परिशादों
parikhaen	परीक्षाएं	परिखाएं
parikshaayein	परीक्षाएं	परिक्षाएं
parikshaen	परीक्षाएं	परिक्षाएं
parosane	परोसने	परोसने
parosne	परोसने	परोसने
parda	पर्दा	परदा
pardaa	पर्दा	परदा
purple	पर्पल	पुरपल
palatne	पलटने	पलाते
paltane	पलटने	पलटतेे
palaari	पलारी	पलारी
palari	पलारी	पालर
pale	पले	पलल
palmonari	पल्मोनरी	पललोमोरी
pulmonary	पल्मोनरी	पुलममननी
plus	पल्स	प्लसस
pulse	पल्स	पल्स
pashtun	पश्तून	पश्टुन
pashtuun	पश्तून	पश्टुओं
pahan	पहन	पहा
pehan	पहन	पहह
pahantaa	पहनता	पहनता
pahnata	पहनता	पहनता
pehnate	पहनता	पहनाते
pahanate	पहनते	पहनाते
pahante	पहनते	पहनते
pehnate	पहनते	पहनते
pahnaakar	पहनाकर	पहनाकर
pahnakar	पहनाकर	पहनाकर
pehnakar	पहनाकर	पहनाकर
pahnaati	पहनाती	पहनाती
pahnati	पहनाती	पहनाती
pehnati	पहनाती	पहनाती
pahani	पहनी	पहनी
pahni	पहनी	पहनी
pehni	पहनी	पहनी
pahno	पहनो	पहनो
pehno	पहनो	पहनों
pahla	पहला	पहला
pahlaa	पहला	पहला
pehla	पहला	पहला
paheliyaan	पहेलियां	पहेलियां
paheliyan	पहेलियां	पहेलियां
paheliyon	पहेलियों	पहेलियों
pide	पाइड	पाइड
pied	पाइड	पाइड
pythagoras	पाइथागोरस	प्थागोसार
pythogaras	पाइथागोरस	प्थोगासर
paakhandi	पाखंडी	पाखंड़
pakhandi	पाखंडी	पखांडी
paathshaalaayein	पाठशालाएं	पाठशालाएं
pathshalayein	पाठशालाएं	पठठशालाएं
pathshalayen	पाठशालाएं	पठठशालाएं
paathyakram	पाठ्यक्रम	पाठ्यक्रम
pathyakram	पाठ्यक्रम	पठठ्क्रम
pathykram	पाठ्यक्रम	पाठ्क्रम
paathyakramon	पाठ्यक्रमों	पाठ्यक्रमों
pathyakramon	पाठ्यक्रमों	पठठ्कररमों
pathykramon	पाठ्यक्रमों	पाठ्यक्रमों
population	पापुलेशन	पोपलल्शन
pailot	पायलट	पेलोट
pilot	पायलट	पिलोट
pailoton	पायलटों	पेलोटों
piloton	पायलटों	पिलोटों
paarampariktaa	पारंपरिकता	पारंपर्किता
paramparikata	पारंपरिकता	परापप्रिकता
paramparikta	पारंपरिकता	परापप्रिता
parnel	पार्नेल	पर्नल
parnell	पार्नेल	पर्ननल
parleron	पार्लरों	परलेरों
parloron	पार्लरों	पार्लरों
parlouron	पार्लरों	परलोरों
paarshad	पार्षद	पार्शद
parshad	पार्षद	परशशद
paarshadon	पार्षदों	पार्षदों
parshadon	पार्षदों	परशशदोों
parshdon	पार्षदों	पररशदों
policy	पालिसी	पॉलीसी
pinta	पिंटा	पिंता
pintaa	पिंटा	पिंता
piega	पिएगा	पीइगा
piyegaa	पिएगा	पियगा
pic	पिक	पीक
pick	पिक	पिक
pik	पिक	पिक
piki	पिकी	पीकी
piky	पिकी	पिकी
picture	पिक्चर	पिक्टर
pigmentation	पिगमेंटेशन	पिंमेटेशनन
pigs	पिग्स	पाग्स
pichde	पिछड़े	पिछड़े
pichhade	पिछड़े	पिछड़े
pijja	पिज्जा	पिजजा
pizza	पिज्जा	पिज़ा
pitaamaha	पितामह	पितामह
pitamah	पितामह	पितामा
pipra	पिपरा	पिपरा
pipraa	पिपरा	पिपरा
pipli	पिपली	पिपली
pearson	पियरसन	पीरसनन
pierson	पियरसन	पियरसन
peary	पियरी	पीरी
piyari	पियरी	पियाी
pisaai	पिसाई	पिसाई
pisai	पिसाई	पिसाई
pihaani	पिहानी	पिहानी
pihani	पिहानी	पिहानी
pib	पीआईबी	पीब
pr	पीआर	पीआरआ
pml	पीएमएल	पीएलएल
pmo	पीएमओ	प्एो
pmch	पीएमसीएच	पीएचचच
psv	पीएसवी	पीपीव
peaking	पीकिंग	पीकिंग
picking	पीकिंग	पिकिंग
peetne	पीटने	पीटने
pitne	पीटने	पीटने
pedia	पीडिया	पेड़या
pidiya	पीडिया	पीड़िया
pidiyaa	पीडिया	पीड़िया
peelepan	पीलेपन	पीलेपन
pilepan	पीलेपन	पीलेपन
pv	पीवी	पीवी
pisa	पीसा	पिसा
putla	पुतला	पुटला
putlaa	पुतला	पुतला
putaliyaan	पुतलियां	पुटलियां
putliyan	पुतलियां	पुटलियां
putaliyon	पुतलियों	पुटलियों
putliyon	पुतलियों	पुटलियों
putali	पुतली	पुटली
putli	पुतली	पुटली
putale	पुतले	पुटले
putle	पुतले	पुटले
putin	पुतिन	पुटीन
putul	पुतुल	पुटुल
punargathan	पुनर्गठन	पुनर्गाान
puna	पुना	पूना
puraane	पुराने	पुराने
purane	पुराने	पुराने
puru	पुरू	पुरु
purjon	पुर्जों	पूर्जों
purzon	पुर्जों	पूर्जों
pulam	पुलम	पुलम
pushkin	पुश्किन	पुष्कीन
pushkarana	पुष्करणा	पुष्करणण
pushkarna	पुष्करणा	पुष्करण
pushkarnaa	पुष्करणा	पुष्करण
pushp	पुष्प	पुष्प
pushpa	पुष्प	पुष्प
pushpa	पुष्पा	पुष्प
pushpaa	पुष्पा	पुष्पा
pushpit	पुष्पित	पुष्पित
pushpon	पुष्पों	पुषपों
poonjikaran	पूंजीकरण	पूंजीकरण
punjikaran	पूंजीकरण	पुंजीकरण
poojaapaath	पूजापाठ	पूजापत
poojapath	पूजापाठ	पूजापथ
pujapath	पूजापाठ	पुजापत
pooranpur	पूरनपुर	पूरापुु
puranpur	पूरनपुर	पुरापपु
purvaabhaas	पूर्वाभास	पूर्वाभास
purvaabhas	पूर्वाभास	पूर्वाभास
purvabhaas	पूर्वाभास	पूर्वाभास
purvabhas	पूर्वाभास	पूर्वाभास
pendulam	पेंडुलम	पेंडुलम
pendulum	पेंडुलम	पेंडलुम
peg	पेग	पेग
pages	पेजेज	पेगेस
pajej	पेजेज	पजेज
pace	पेस	पेस
pes	पेस	पेस
pastry	पेस्ट्री	पेस्ट्री
pangolin	पैंगोलिन	पांगलिन
pengolin	पैंगोलिन	पेंगललिन
packard	पैकर्ड	पककरर्ड
package	पैकेज	पकके
packageon	पैकेजों	पककेगों
packagon	पैकेजों	पककागों
packajon	पैकेजों	पककाों
paim	पैम	पैम
pam	पैम	पा
paratrooper	पैराट्रूपर	परततपूर
peratrupers	पैराट्रूपर	पेराटर्रसस
paranormal	पैरानॉर्मल	पराोरामल
peranormal	पैरानॉर्मल	पेरानोम्
paraffin	पैराफिन	परफफी
parafin	पैराफिन	परफीी
perafin	पैराफिन	पेरफीन
parabola	पैराबोला	परबोला
perabola	पैराबोला	पेराबलल
polimer	पॉलिमर	पॉलियर
polymer	पॉलिमर	पॉलियर
polishing	पॉलिशिंग	पॉलिशिंग
pokar	पोकर	पोकर
poker	पोकर	पोकर
polish	पोलिश	पोलिश
poshit	पोषित	पोशित
posta	पोस्ता	पोस्टा
pau	पौ	पाऊ
pyade	प्यादे	प्याड
prakriya	प्रक्रिया	प्रक्रिय
prakshepak	प्रक्षेपक	प्रक्षेपक
pratigya	प्रतिज्ञा	प्रतिग्ञ
prtigyaa	प्रतिज्ञा	प्रतिग्य
pratibhutiyan	प्रतिभूतियां	प्रतिभितियां
pratiyon	प्रतियों	प्रतियों
prativaad	प्रतिवाद	प्रतिवाद
prativad	प्रतिवाद	प्रतिवाद
prativadi	प्रतिवादी	प्रतिवादी
pratishat	प्रतिशत	प्रतिशत
praneet	प्रनीत	प्राीतत
pranit	प्रनीत	प्राित
prapaat	प्रपात	प्रपात
prapat	प्रपात	प्रपतत
prapaaton	प्रपातों	प्रपातों
prapaton	प्रपातों	प्रपातों
prabodhini	प्रबोधिनी	प्रबोधिनी
prayaasrat	प्रयासरत	प्रसासर्त
prayasarat	प्रयासरत	प्रसासरत
pradarshan	प्रर्दशन	प्रदर्शण
prardashan	प्रर्दशन	प्रदर्शन
pravati	प्रवत्ति	प्रवाती
pravatti	प्रवत्ति	प्रवत्ति
prashaasanik	प्रशासनिक	प्रशासानिक
prashasanik	प्रशासनिक	प्रशासानिक
prashasnik	प्रशासनिक	प्रशासािि
prashaasanon	प्रशासनों	प्रशासनों
prashansanon	प्रशासनों	प्रशासनों
prashasanon	प्रशासनों	प्रशासनों
prashikshu	प्रशिक्षु	प्रशिक्ष
prastaavon	प्रस्तावों	प्रस्तावों
prastavon	प्रस्तावों	प्रस्तावों
prahlaad	प्रहलाद	प्रभालाद
prahlad	प्रहलाद	प्रभाल
prahasan	प्रहसन	प्रमासन
prahsan	प्रहसन	प्रशान
prahaarak	प्रहारक	प्रहारक
praharak	प्रहारक	प्रहारक
prahad	प्रह्लाद	प्रह्लाद
prahlad	प्रह्लाद	प्रभाल
privacy	प्राइवेसी	प्राइस
praakkathan	प्राक्कथन	प्रकक्ठन
prakkathan	प्राक्कथन	प्रकाठान
praan	प्राण	प्रान
pran	प्राण	प्रण
pranon	प्राणों	प्रणों
prathamik	प्राथमिक	प्रााममक
prathmik	प्राथमिक	प्राममिक
praathmikata	प्राथमिकता	प्राा्मिकता
prathmikta	प्राथमिकता	प्राथमिकता
prathmiki	प्राथमिकी	प्राममिक
pradhyapakon	प्राध्यापकों	प्रा्ययपकों
prapt	प्राप्त	प्रपप्त
prapta	प्राप्त	प्रपतता
prapti	प्राप्ती	प्रपतति
praroop	प्रारूप	प्रपूप
prarup	प्रारूप	प्रपूप
priyamani	प्रियामणि	प्रियमणी
proof	प्रूफ	प्रूफ
pruf	प्रूफ	प्रु
prekshakon	प्रेक्षकों	प्रेक्षकों
prem	प्रेम	प्रेम
premlata	प्रेमलता	प्रेमलाा
prema	प्रेमा	प्रेमा
premi	प्रेमी	प्रेमी
profit	प्रॉफिट	प्रोफिट
processing	प्रॉसेसिंग	प्रोसेसिंग
programers	प्रोग्रामर्स	प्रोग्रामरस
programmers	प्रोग्रामर्स	प्रोग्रामर्स
programs	प्रोग्रामर्स	प्रोग्रास
proto	प्रोटो	प्रोटो
propellant	प्रोपेलेंट	प्रोपेेंंट
propellent	प्रोपेलेंट	प्रोपेेंं
praudh	प्रौढ	प्रौढ़
proud	प्रौढ	प्रौढ
plan	प्लेन	प्लान
plane	प्लेन	प्लेने
fund	फंड	फुंड
funda	फंडा	फूंडा
funding	फंडिंग	फंंििंग
fandon	फंदों	फांडों
fagua	फगुआ	फागु
fatane	फटने	फटने
phatane	फटने	फटने
phatne	फटने	फटने
fadfadata	फड़फड़ाता	फड़फड़ता
phadphadata	फड़फड़ाता	फड़़फाता
fatehgadh	फतेहगढ़	फतेहंढ़
fatehgarh	फतेहगढ़	फटेहगढ़
fabti	फब्ती	फाती
phabti	फब्ती	फबकी
farse	फरसे	फरसे
pharase	फरसे	फररस
pharse	फरसे	फर्स
farheen	फरहीन	फरहहन
farhin	फरहीन	फरहहन
farth	फर्थ	फर्थ
ferth	फर्थ	फर्थ
pharth	फर्थ	फर्थ
farmion	फर्मिऑन	फर्मियों
fermion	फर्मिऑन	फर्मियों
firmian	फर्मिऑन	फर्मियान
farookhabad	फर्रुखाबाद	फर्रुखाबाद
farrukhabad	फर्रुखाबाद	फरुखराड
farukhabad	फर्रुखाबाद	फरुखाबड़
farookhnagar	फर्रूखनगर	फरूचनार
farrukhnagar	फर्रूखनगर	फरूखगार
farukhnagar	फर्रूखनगर	फरखखनर
falata	फलता	फलता
falta	फलता	फलता
phalata	फलता	फलता
falne	फलने	फलने
phalne	फलने	फलने
falitarth	फलितार्थ	फलीततरथ
phalitartha	फलितार्थ	फलित्राा
falibhoot	फलीभूत	फललभूत
falibhut	फलीभूत	फललिभूत
phalibhoot	फलीभूत	फलिभूत
favvara	फव्वारा	फव्वारा
fawaara	फव्वारा	फवारा
favvare	फव्वारे	फव्वारे
fawaare	फव्वारे	फवारे
favvaron	फव्वारों	फव्वारों
fawaaron	फव्वारों	फवारों
faisala	फ़ैसला	फैसला
faisla	फ़ैसला	फैसला
follow	फ़ॉलो	फ़ॉलो
faansi	फांसी	फांसी
fansi	फांसी	फासी
fatama	फातमा	फटमम
fatma	फातमा	फटमा
faaf	फाफ	फाक
phaaph	फाफ	फाच
farsi	फारसी	फारसी
forcee	फारसी	फॉरससी
farm	फार्म	फर्म
form	फार्म	फॉर्म
farmic	फार्मिक	फर्मििक
formic	फार्मिक	फॉर्मिक
formulae	फार्मूले	फार्मूले
formule	फार्मूले	फार्मूले
formuley	फार्मूले	फारममल
pharmacy	फार्मेसी	फरम्सी
pharma	फार्मों	फरमा
pharmon	फार्मों	फरमों
farms	फार्म्स	फर्मस
finger	फिंगर	फाइगर
fikra	फिक्र	फिकरा
physician	फिजिशियन	फिसिकिना
firti	फिरती	फिरती
fisla	फिसला	फिसला
fislaa	फिसला	फिसला
feeder	फीडर	फीडड
fulaaye	फुलाए	फूलाए
fulae	फुलाए	फूलाई
fulay	फुलाए	फूले
furti	फूर्ति	फुर्ति
phurti	फूर्ति	फूर्ति
fus	फूस	फसस
phoos	फूस	फूज
phus	फूस	फसस
feka	फेका	फेका
fefada	फेफड़ा	फेफड़
fefda	फेफड़ा	फेफड़
facial	फेशियल	फैसिल
fact	फैक्ट	फैक्ट
federal	फैडरल	फेररल
failkar	फैलकर	फैलकर
failaaiye	फैलाइए	फैलाये
failaea	फैलाइए	फैलाई
failaiya	फैलाइए	फैलाया
failaiye	फैलाइए	फैलाये
failegi	फैलेगी	फैइलगी
font	फॉन्ट	फोंट
fogat	फोगाट	फोगट
phogat	फोगाट	फोगट
fod	फोड़	फॉड
phod	फोड़	फॉड
foda	फोड़ा	फोड़
fodaa	फोड़ा	फोड़
phoda	फोड़ा	फोड़
fode	फोड़े	फोड़
phode	फोड़े	फोड़
fodo	फोड़ों	फोडो
fodon	फोड़ों	फोड़ों
phodo	फोड़ों	फोडो
fortis	फोर्टिस	फोर्टिस
fusion	फ्यूजन	फुसियो
fuji	फ्यूजी	फ्यूजी
fyuji	फ्यूजी	फ्जूजी
francisca	फ्रांसिस्का	फ्रांकिसिसा
franciska	फ्रांसिस्का	फ्रांकिसि
fransiska	फ्रांसिस्का	फ्रांसिका
francisco	फ्रांसिस्को	फ्रांकिक्सो
francisko	फ्रांसिस्को	फ्रैंकिक्स
fransisko	फ्रांसिस्को	फ्रांसिको
fringe	फ्रिंज	फ्रिंग
friendship	फ्रेंडशिप	फ्रिंडििप
frost	फ्रॉस्ट	फ्रोस्ट
flin	फ्लिन	फ्लिन
flynn	फ्लिन	फ्लान
flesh	फ्लेश	फ्लेश
bang	बंग	बैंग
bung	बंग	बंग
bangbandhu	बंगबंधु	बंगबंधु
bangbhang	बंगभंग	बंगभंग
bangash	बंगश	बंगाश
bangsh	बंगश	बैंग्
bantane	बंटने	बंंटने
bantne	बंटने	बंंटे
bandhati	बंधती	बांधति
bandhti	बंधती	बांधी
bandhan	बंधान	बांधन
bandhuon	बंधुओं	बंंुओं
bamba	बंबा	बांब
mumba	बंबा	मुंबा
bakaayon	बकायों	बकाययों
bakayon	बकायों	बकाययों
bakaul	बकौल	बककल
bakoul	बकौल	बककल
baksa	बक्सा	बकसा
baksi	बक्सी	बक्सी
bakse	बक्से	बककसे
bakhshane	बख्शने	बख्शाने
bakhshne	बख्शने	बख््शे
bagad	बगड़	बागढ
bagd	बगड़	बागड
bageechi	बगीची	बगीची
bagichi	बगीची	बगीची
bachat	बचत	बचात
bachati	बचती	बचात
bachti	बचती	बचती
bajana	बजना	बजना
bajrangi	बजरंगी	बजरंंगी
bajaj	बजाज	बजजज
batalvi	बटालवी	बतललवी
badhachadhakar	बढ़ाचढ़ाकर	बढधाच्ाक
badata	बढ़ाता	बद़ता
badhaataa	बढ़ाता	बढ़ाता
badhata	बढ़ाता	बढ़ता
badhaati	बढ़ाती	बढ़ात
badhati	बढ़ाती	बढ़ती
badhayi	बढ़ायी	बढ़ाय
badhav	बढ़ाव	बढ़ाव
badhotari	बढ़ोतरी	बढौोतरी
badhotri	बढ़ोतरी	बाधोत्री
batlaae	बतलाए	बतलाए
batlaaye	बतलाए	बतलाए
batlae	बतलाए	बतलाई
batlaye	बतलाए	बतलाए
batlaakar	बतलाकर	बतलाकर
batlakar	बतलाकर	बतलाकर
badlapur	बदलापुर	बदलपपुर
badali	बदली	बदली
badli	बदली	बदली
badam	बदाम	बदाम
banva	बनवा	बावा
banvaa	बनवा	बनवा
banaam	बनाम	बनाम
banam	बनाम	बनाम
bnaam	बनाम	बनाम
baniya	बनिया	बनिया
banu	बनू	बाुु
barpaayaa	बरपाया	बर्पया
barpaya	बरपाया	बर्पया
barsa	बरसा	बरसा
barsaata	बरसाता	बरसाता
barsaataa	बरसाता	बरसाता
barsata	बरसाता	बरसता
barhad	बरहद	बारहद
baraat	बरात	बरात
barat	बरात	बारत
braat	बरात	ब्रात
baraamad	बरामद	बरााद
baramad	बरामद	बरामद
bramad	बरामद	ब्रमाद
baramade	बरामदे	बरामदे
baramde	बरामदे	बररंदे
bare	बरे	बार
birth	बर्थ	बीर्थ
baljeet	बलजीत	बललीि
baljit	बलजीत	बलजीत
ballabh	बल्लभ	बल्लभभ
balla	बल्ला	बल्ल
balli	बल्ली	बल्ल
basava	बसावा	बसवा
bastiyon	बस्तियों	बस्तियों
bahroopiya	बहरूपिया	बहरूपिय
bahrupiya	बहरूपिया	बहरूपिय
bahamaas	बहामास	बहासस
bahamas	बहामास	बहासस
bahaav	बहाव	बहाव
bahav	बहाव	बहाव
bhav	बहाव	भाव
bahavalpur	बहावलपुर	बहावलपुर
bahawalpur	बहावलपुर	बहालापुर
bahuchara	बहुचरा	बहुचार
banthia	बांठिया	बांठिय
banthiya	बांठिया	बांठयय
bandhate	बांधते	बंंाते
bandhte	बांधते	बंंठे
banbi	बांबी	बंंब
bombi	बांबी	बोमबब
bounceron	बाउंसरों	बाउंकरर
bowling	बाउलिंग	बॉउििंग
baku	बाकू	बककू
bakuu	बाकू	बाकू
baag	बाग	बाग
bag	बाग	बैग
bagh	बाग	बाघ
bagabani	बागबानी	बगगबाीी
bagbani	बागबानी	बैगबाीी
bagali	बागली	बगली
bagli	बागली	बगली
baagiyon	बागियों	बागियों
bagiyon	बागियों	बगगियों
baago	बागो	बागो
bago	बागो	बगगो
baji	बाज़ी	बाज़ी
bazi	बाज़ी	बाजी
bajaru	बाजारू	बाजरू
bazaru	बाजारू	बाजारू
bajuon	बाजुओं	बाजुओं
badh	बाध	बढ़
badha	बाधा	बढ़ा
baadhaaon	बाधाओं	बाधाओं
baadhaon	बाधाओं	बाधाओं
badhaaon	बाधाओं	बढ़ाओं
badhaon	बाधाओं	बाधाओं
baadhit	बाधित	बाधित
badhit	बाधित	बढ़ित
baani	बानी	बानी
bani	बानी	बानी
baapa	बापा	बापा
baapaa	बापा	बापा
bapa	बापा	बापा
bapaa	बापा	बापा
baabat	बाबत	बाबत
babat	बाबत	बबत
babt	बाबत	बबत
bayern	बायर्न	बायरन
byrun	बायर्न	ब्रून
barah	बारह	बररह
baarahamaasee	बारहमासी	बारहहाससी
barahamasi	बारहमासी	बरहमाससी
barahmasi	बारहमासी	बररमहससी
barahsinga	बारहसिंगा	बररससिंग
barasingha	बारहसिंगा	बरससंंह
bala	बाला	बाा
baalti	बाल्टी	बालती
balti	बाल्टी	बलती
balty	बाल्टी	बाल्ी
baldvin	बाल्डविन	बालव्वी
baldwin	बाल्डविन	बालव्वी
bavaji	बावजी	बावजज
bavji	बावजी	बावजज
baawaraa	बावरा	बावरा
bavra	बावरा	बावरा
bawara	बावरा	बावरा
baahulya	बाहुल्य	बौहुल्य
bahuly	बाहुल्य	बहुल्य
bahulya	बाहुल्य	बहुल्य
box	बाॅक्स	बॉक्स
bikherati	बिखेरती	बीखररत
bikherti	बिखेरती	बीखेती
biggest	बिगेस्ट	बागग्सटट
bichhua	बिछुआ	बिछुआ
bichhuaa	बिछुआ	बिछुआ
biji	बिजी	बीजी
busy	बिजी	बसस
buzy	बिजी	बुज्य
bipin	बिपिन	बापिन
bilae	बिलाई	बिलाई
bilai	बिलाई	बिलाई
billa	बिल्ला	बिल्ला
billaa	बिल्ला	बिला
bilhaur	बिल्हौर	बिलहहू
bisva	बिस्वा	बीसवव
biswa	बिस्वा	बिसवव
bag	बीएजी	बैग
bikaner	बीकानेर	बीकानेर
bikaneri	बीकानेरी	बिकानीी
bk	बीके	बीक
beejak	बीजक	बीजक
bijak	बीजक	बिजक
beef	बीफ	बीफ
beem	बीम	बीम
bim	बीम	बीम
beemon	बीमों	बीमोन
bimon	बीमों	बायमन
beerganj	बीरगंज	बीरंंज
birganj	बीरगंज	बिरंगज
beesavaan	बीसवां	बीसवान
bisavan	बीसवां	बीसवनन
bisawan	बीसवां	बीसवनन
beast	बीस्ट	बिस्ट
budvig	बुडविग	बडविवग
budwig	बुडविग	बडवििग
bull	बुल	बुल
bulaao	बुलाओ	बुलाओ
bulao	बुलाओ	बुलाओ
bule	बुले	बुले
bulletin	बुलेटिन	बुलेकिन
brijesh	बृजेश	बृजेश
benvar	बेंवर	बेनवर
benwar	बेंवर	बेनवर
beaulad	बेऔलाद	बीलाड
bekaaboo	बेकाबू	बेकाबू
bekabu	बेकाबू	बेकाबू
bechakar	बेचकर	बेचकर
bechkar	बेचकर	बेचकर
bechate	बेचते	बेचते
bechte	बेचते	बेचते
bediyan	बेड़ियां	बेड़ियां
bethanal	बेथनल	बेतानल
bethnal	बेथनल	बेथनल
benis	बेनिस	बेनिस
belacha	बेलचा	बेलचच
belcha	बेलचा	बेलचा
belinda	बेलिंडा	बेलिंदा
bevkufana	बेवकूफाना	बेवफकना
bewakoofaanaa	बेवकूफाना	बेवकूकनना
bewkufana	बेवकूफाना	बेवकूफना
besahaaraa	बेसहारा	बेसहाा
besahara	बेसहारा	बेसहरा
basin	बेसिन	बेसिन
besin	बेसिन	बेसिन
basil	बेसिल	बेसि
besil	बेसिल	बेसिल
bandage	बैंडेज	बंंगेे
bandej	बैंडेज	बंंेज
baithantey	बैठते	बैठनेे
baithate	बैठते	बैठते
baitool	बैतूल	बैटलल
baitul	बैतूल	बैटलल
betul	बैतूल	बेटूल
baini	बैनी	बैनी
beni	बैनी	बेनी
bairakpur	बैरकपुर	बैरकपुर
barrackpore	बैरकपुर	बार्ककरर
baila	बैला	बैला
bella	बैला	बेलाला
ballistic	बैलिस्टिक	बललिटिस्क
bells	बैल्स	बेल्स
bostan	बॉस्टन	बोस्टा
bosten	बॉस्टन	बॉस्टन
boston	बॉस्टन	बॉस्टन
bokaro	बोकारो	बोकरों
bodara	बोदरा	बोड़रा
bodra	बोदरा	बोद्रा
bodraa	बोदरा	बोद्रा
bona	बोना	बोना
borkar	बोरकर	बोरकर
borivali	बोरीवली	बोरिवाली
boriwali	बोरीवली	बोरिवली
born	बोर्न	बोर्न
bolane	बोलने	बोलने
boliae	बोलिए	बोलिया
boliy	बोलिए	बोलीय
boliye	बोलिए	बोलिए
bosaan	बोसान	बोसान
bosan	बोसान	बोसन
bauni	बौनी	बौनी
bouni	बौनी	बोनी
byaawa	ब्यावर	बयावा
byavar	ब्यावर	बययवर
brajesh	ब्रजेश	ब्रेजश
brijesh	ब्रजेश	बृजेश
brahmalin	ब्रह्मलीन	ब्रह्ममली
brahmleen	ब्रह्मलीन	ब्रह्मिल
brahmlin	ब्रह्मलीन	ब्रह्मिल
bravo	ब्रावो	ब्रावो
brigatn	ब्रिगटन	ब्रिगटट
brighton	ब्रिगटन	ब्घिटटो
brigton	ब्रिगटन	ब्रिगटो
brigadier	ब्रिगेडियर	ब्रिगडडर
britain	ब्रिटेन	ब्रिटन
breed	ब्रीद	ब्रीड
brock	ब्रोक	ब्रॉक
brok	ब्रोक	ब्रोक
broke	ब्रोक	ब्रोक
brocken	ब्रोकन	ब्रॉकेन
broken	ब्रोकन	ब्रॉकन
blosam	ब्लॉसम	ब्लॉसम
blossom	ब्लॉसम	ब्लॉसम
bhagaane	भगाने	भगाने
bhagane	भगाने	भगाने
bhadakaaya	भड़काया	भड़काया
bhadakaya	भड़काया	भड़काया
bhadkaayaa	भड़काया	भड़काया
bhadkaya	भड़काया	भड़काया
bharakaaya	भड़काया	भड़काया
bharakaya	भड़काया	भड़काया
bhabhoot	भभूत	भभूत
bhabhut	भभूत	भभूत
bhay	भय	भाय
bhaya	भय	भयय
bhayo	भयो	भायो
bharatanatyam	भरतनाट्यम्	भररतनत््म
bharatnatyam	भरतनाट्यम्	भररतनत्यम
bhartnatyam	भरतनाट्यम्	भरततनात्म
bharate	भरते	भररते
bharte	भरते	भर्ते
bharani	भरनी	भरनीी
bharni	भरनी	भरणी
bharane	भरने	भरने
bharne	भरने	भरने
bhara	भरा	भरर
bhavishya	भविष्य	भविष्य
bhaate	भाते	भाटे
bhate	भाते	भटेे
bhanu	भानू	भानू
bhabar	भाबर	भबर
bhareeye	भारीय	भरीए
bhariy	भारीय	भारीय
bhavanaon	भावनाओं	भवानाओं
bhavnaon	भावनाओं	भावनाओं
bhaskar	भास्कर	भसकर
bheed	भीड़	भीड़
bheera	भीरा	भीरा
bhira	भीरा	भीरा
bheesham	भीष्म	भीषम
bhisham	भीष्म	भीष्म
bhishm	भीष्म	भीष्म
bhugat	भुगत	भूगत
bhugata	भुगता	भूगता
bhugta	भुगता	भूगता
bhutto	भुट्टो	भूटतों
bhumi	भुमि	भूमी
bhurbhura	भुरभुरा	भूरभुरा
bhookh	भूख	भूख
bhukh	भूख	भूख
bhookhi	भूखी	भूखी
bhukhi	भूखी	भूखी
bhoogol	भूगोल	भूगोल
bhugol	भूगोल	भूगोल
bhootal	भूतल	भूतल
bhutal	भूतल	भूतल
bhoopsingh	भूपसिंह	भूपिंघ
bhupsingh	भूपसिंह	भूपसिंघ
bhumi	भूमी	भूमी
bhumika	भूमी	भूमिका
bhulata	भूलता	भूलता
bhulataa	भूलता	भूलता
bhulta	भूलता	भूलता
bhula	भूला	भूला
bhulaa	भूला	भुला
bhooli	भूली	भूली
bhuli	भूली	भूली
bhulo	भूलो	भूलो
bhulon	भूलों	भूलों
bhusi	भूसी	भूसी
bhooswaami	भूस्वामी	भूस्वामी
bhusvami	भूस्वामी	भूस्वामी
bhuswami	भूस्वामी	भूस्वामी
bhengapan	भेंगापन	भेंगपपन
bhairavnath	भैरवनाथ	भैरवानाथ
bhairo	भैरो	भैरो
bhogatey	भोगते	भोगते
bhogte	भोगते	भोगते
bhola	भोला	भोला
bholi	भोली	भोली
bholu	भोलू	भोलू
bhaunho	भौंहों	भौनहों
bhaunhon	भौंहों	भौनहों
bhoonhon	भौंहों	भूंहों
bhraant	भ्रांत	भररां
bhrant	भ्रांत	भ्रतं
brant	भ्रांत	ब्रांट
bhraanti	भ्रांति	भरराती
bhranti	भ्रांति	भ्रनति
branti	भ्रांति	ब्रांि
bhraantiyan	भ्रांतियां	भ्रनततियां
bhrantiyan	भ्रांतियां	भ्रांतियां
bhraantiyon	भ्रांतियों	भ्रानतियों
bhrantiyon	भ्रांतियों	भ्रतणियों
mangesh	मंगेश	मंगेश
manch	मंच	मांच
manchit	मंचित	मांचित
mancheeye	मंचीय	मांचीय
manchiy	मंचीय	मांचीय
manchiya	मंचीय	मंचीय
manchon	मंचों	माचचों
manjil	मंजिल	मांजल
manzil	मंजिल	मांजलल
manjila	मंजिला	मंजलीा
manzila	मंजिला	माजजलला
manjilein	मंजिलें	मांजेले
manjilen	मंजिलें	मांजलले
manzilein	मंजिलें	मांजेलि
manto	मंटो	मांोो
mantriyon	मंत्रियों	मंत्रिोंों
makrani	मकरानी	मकरानी
maksad	मक्सद	मककसद
makhdumpur	मखदुमपुर	मखदूपपुर
machaaye	मचाए	मचाए
machae	मचाए	मचाए
machaye	मचाए	मचाए
machaanon	मचानों	मचानों
machanno	मचानों	मचानों
machano	मचानों	मचानो
machanon	मचानों	मचानों
madaura	मढ़ौरा	मदौरा
madhuara	मढ़ौरा	मधुरा
madhura	मढ़ौरा	माुरा
manipal	मणिपाल	मानपपल
matpatron	मतपत्रों	मा्तपरोो
matthe	मत्थे	मत्ठे
matsyavatar	मत्स्यावतार	मत्स्यावतार
matsyavtar	मत्स्यावतार	मा्त्यववस्र
masyendranath	मत्स्येंद्रनाथ	मसानेद्रननथथ
matsyendranath	मत्स्येंद्रनाथ	मा्सननेद्रनम
madhupur	मधुपुर	मधुपुर
manmarji	मनमर्जी	मनममराजी
manae	मनाए	मनाए
manaye	मनाए	मााए
mnaey	मनाए	मनाए
mam	मम	माम
mum	मम	मम
maryokar	मयोर्का	मारोककर
mayorka	मयोर्का	मयोर्क
mayorkaa	मयोर्का	मयोरकक
mardaani	मरदानी	मर्दननी
mardani	मरदानी	मरदानी
marmar	मरमर	मरममर
murmur	मरमर	मुरमूर
maratha	मराठा	मााथ
marathi	मराठी	मााठी
marji	मर्जी	माजी
mardanagi	मर्दानगी	मर्दनागी
mardangi	मर्दानगी	मरददंगी
mardo	मर्दों	मारोड
mardon	मर्दों	मरदोोों
maryaadaa	मर्यादा	मररयाद
maryada	मर्यादा	मररयदा
maryaadaaon	मर्यादाओं	मररयादाओं
maryadaon	मर्यादाओं	मररययदन
malaga	मलागा	मालगा
malaar	मलार	मलार
malar	मलार	मालर
mashrak	मशरक	मशरक
masaaledaar	मसालेदार	मसालेदार
masaledaar	मसालेदार	मसालेदार
masaledar	मसालेदार	मसालेदार
masoor	मसूर	मसूर
masur	मसूर	मसूर
masse	मस्से	मसेस
mahakane	महकने	महाकने
mahakne	महकने	महाने
mahkane	महकने	महकने
mehkane	महकने	महकने
mahalon	महलों	महललों
mahlon	महलों	महलों
mahagranth	महाग्रंथ	महाग्रंथ
mhagranth	महाग्रंथ	महाग्रंथ
mahajan	महाजन	महाजन
mhajan	महाजन	महाजन
mahathir	महाथिर	महाथिर
mhathir	महाथिर	महाथिर
mahanatam	महानतम	महानतम
mahantam	महानतम	महाततम
mhantam	महानतम	महानतम
mahanideshak	महानिदेशक	महानिदेशक
mahanirdeshak	महानिदेशक	महानेर्धकष
mhanideshak	महानिदेशक	महानेदिशक
mahapauron	महापौरों	महापररों
mhapauron	महापौरों	महापारों
mahapran	महाप्राण	महापररण
mhapran	महाप्राण	महापर्ण
mahamantr	महामंत्र	महामंत्
mahamantra	महामंत्र	महामंत्र
mhamantra	महामंत्र	महामंत्र
maharaja	महाराजा	महारजा
mahavigyan	महाविज्ञान	महाजिज्ञा
mhavidyan	महाविज्ञान	महाविद्ञान
mahavidya	महाविद्या	महाविद्या
mhavidya	महाविद्या	महाविद्य
mahavishnu	महाविष्णु	महाविस्ण
mahasingh	महासिंह	महासिंह
mahasinh	महासिंह	महासिनह
mahipal	महिपाल	महिपाल
mahin	महीन	माहन
mahinon	महीनों	महीनों
maang	मांग	मांग
mang	मांग	माग
mangani	मांगनी	मंगानी
mangni	मांगनी	मंगगनी
maanga	मांगा	मांगा
manga	मांगा	मंगा
maangi	मांगी	मांगी
mangi	मांगी	मंगी
maange	मांगे	मांगे
mange	मांगे	मांगे
mango	मांगो	मंगोो
maori	माओरी	माओरी
maajin	माजिन	माजि
majin	माजिन	माीन
mathe	माथे	माठे
mathey	माथे	माथे
maap	माप	माप
map	माप	माप
mop	माप	माप
mamooli	मामूली	ममूूली
mamuli	मामूली	ममूली
mame	मामे	मामे
maarvaad	मारवाड़	मारवाद
marvad	मारवाड़	मार्द
marwar	मारवाड़	मारवर
maariya	मारिया	मारिया
mariya	मारिया	मररिय
maariyo	मारियो	मारियो
mario	मारियो	मैरियो
mariyo	मारियो	मैरियो
martha	मार्था	मारथ
maalish	मालिश	मालिश
malish	मालिश	मालिश
mave	मावे	माव
mavey	मावे	मावे
maas	मास	मास
mas	मास	मास
mass	मास	मासस
maason	मासों	मासों
mason	मासों	मसों
mitaao	मिटाओ	मिटाए
mitao	मिटाओ	मिटाए
mithaai	मिठाई	मिठाई
mithai	मिठाई	मिठाई
media	मिडिया	मेडिया
mithila	मिथिला	मिथिला
mithilanchal	मिथिलांचल	मिथिलानल
mithya	मिथ्या	मिठ्य
mimicry	मिमिक्री	मायिक्री
milkiyat	मिल्कियत	मिलिकित
misha	मिशा	मिशा
mungeri	मुंगेरी	मुंगरर
mundva	मुंडवा	मुंडवा
mundwa	मुंडवा	मुंडवा
munshiganj	मुंशीगंज	मुंशिंगज
mukarte	मुकरते	मुकर्त
mukartey	मुकरते	मुकररत
mukhopadhyaya	मुखोपाध्याय	मुखोक़़यय
mukhyopadhyaay	मुखोपाध्याय	मुख्यकाधयय
mukhyamantri	मुख्यमंत्री	मुख्यमंत्री
munaf	मुनाफ	मुना
munafa	मुनाफा	मुनाा
munnu	मुन्नू	मुननू
mufalisi	मुफलिसी	मुफलसीी
muflisi	मुफलिसी	मुफलिसी
mubarakpur	मुबारकपुर	मुबारपुर
mubarkpur	मुबारकपुर	मुबर्पुर
murjha	मुर्झा	मुरझा
multae	मुल्ताई	मूलताए
multai	मुल्ताई	मुलताई
mushahid	मुशाहिद	मुशहहिद
muhavare	मुहावरे	मुहावेर
muhavre	मुहावरे	मुहावेे
mooth	मूठ	मूठ
muth	मूठ	मूठ
mood	मूड	मूद
mud	मूड	मुद
moodi	मूडी	मूदी
moody	मूडी	मूद्य
mool	मूल	मूल
mul	मूल	मूल
moolchand	मूलचंद	मूलंंद
mulchand	मूलचंद	मूलचंद
moolar	मूलर	मूलर
mular	मूलर	मुलर
muller	मूलर	म्लूल
moolon	मूलों	मूलों
mulon	मूलों	म्लों
maxico	मेक्सिको	मैक्सिको
mexico	मेक्सिको	मेक्सिको
mega	मेगा	मेगा
megapixal	मेगापिक्सल	मैगिप्टल
megapixel	मेगापिक्सल	मैगेप्टिल
mejbaan	मेजबान	मेजबन
mejban	मेजबान	मेंबे
mezbaan	मेजबान	मेजबन
mejabani	मेजबानी	मेजबानी
mejbaani	मेजबानी	मेजबानी
mejbani	मेजबानी	मेंबीनी
mezabani	मेजबानी	मेजबानी
mejbaan	मेज़बान	मेजबन
mejban	मेज़बान	मेंबे
mezbaan	मेज़बान	मेजबन
mejbaani	मेज़बानी	मेजबानी
mejbani	मेज़बानी	मेंबीनी
mezbaani	मेज़बानी	मेजबानी
mate	मेट	माते
met	मेट	मेट
mates	मेट्स	मेट्स
medical	मेडीकल	मेडिकल
methanol	मेथेनॉल	मैथेनो
menu	मेनू	मेनू
mem	मेम	मेम
melaghaat	मेलघाट	मेलाजत
melghat	मेलघाट	मेलाट
melaanin	मेलानिन	मेलानिन
melanin	मेलानिन	मेलानिन
melaani	मेलानी	मेलानी
melani	मेलानी	मेलननी
maheman	मेहमान	महेमान
mehamaan	मेहमान	मेहमन
mehaman	मेहमान	मेहमन
mehmaan	मेहमान	महहमान
mehman	मेहमान	महहमन
meharaam	मेहराम	मेहराम
mehram	मेहराम	मेहराम
macbook	मैकबुक	मककूक
matix	मैट्रिक्स	मैटिक्स
matrix	मैट्रिक्स	मैट्रिक्स
mad	मैड	माद
made	मैड	मैड
maid	मैड	मैद
maddy	मैडी	मद्दय
maidi	मैडी	मैदी
main	मैन	मैन
man	मैन	मान
men	मैन	मेन
mainan	मैनन	मैनन
menon	मैनन	मेनों
manner	मैनर	मैनर
maina	मैना	मैना
maine	मैने	मैइने
marrej	मैरेज	मररेज
marriage	मैरेज	मैरिजे
merraige	मैरेज	मेरेगे
maisachusets	मैसाचुसेट्स	माससेेक्ट्स
massachusetts	मैसाचुसेट्स	मससमेक्स्््स
maisor	मैसोर	मैसर
maisore	मैसोर	मैसरर
mysore	मैसोर	मससरर
mod	मॉड	मॉड
mode	मॉड	मॉड
modern	मॉडर्न	मॉडर्न
module	मॉड्यूल	मोडले
modules	मॉड्यूल्स	मॉडलेस
modyuls	मॉड्यूल्स	मॉड्िल्स
mauritious	मॉरिशस	मॉरिटियम
mauritius	मॉरिशस	मॉरिटिस
mogali	मोगली	मोगली
mowgli	मोगली	मोगली
motive	मोटिव	मोटववे
mol	मोल	मोल
mold	मोल्ड	मोल्ड
moshe	मोशे	मोश
mosad	मोसाद	मोसाद
mohana	मोहाना	मोहना
mohani	मोहानी	मोहनी
mohini	मोहिनी	मोहिनी
mohim	मोहिम	मोहिम
maukon	मौकों	मौकों
mauma	मौमा	मौमा
maurya	मौर्या	मौर्य
morya	मौर्या	मोर्य
maurya	मौर्यों	मौर्यों
mauryon	मौर्यों	मौर्यों
moryon	मौर्यों	मोर्यों
maulaviyon	मौलवियों	मौलववियों
maulvidon	मौलवियों	मौलववदों
maulviyon	मौलवियों	मौलवियों
maule	मौले	मौले
mauley	मौले	मौले
mausa	मौसा	मौसा
yatn	यत्न	याटन
yatna	यत्न	यानन
yada	यदा	यादा
yda	यदा	एद
yaduvansh	यदुवंश	यादवेशं
yaduwansh	यदुवंश	यादवेशं
jerusalem	यरूशलेम	जेरसस्ल
yarooshaleim	यरूशलेम	यरूशशतलम
yarushalem	यरूशलेम	यशुस्ले
yashpaal	यशपाल	यशपपल
yashpal	यशपाल	यशपाल
yaatna	यातना	याटना
yatna	यातना	यानन
yaatanaon	यातनाओं	यातनाओं
yatnaon	यातनाओं	याननाओं
yarayan	यात्राएं	यााया
yatraein	यात्राएं	यातररएं
yatraen	यात्राएं	यातरराएं
yaariyan	यारियां	यारियां
yariyan	यारियां	यरियां
yaari	यारी	यारी
yari	यारी	यारी
yugam	युग्म	युगम
yugm	युग्म	युगम
yuddhrat	युद्धरत	युद्धात
yudhrat	युद्धरत	युद्धत
ukrainian	यूक्रेनियन	उकक्रेनियां
ukranian	यूक्रेनियन	उकक्रीनीय
jerusalem	येरुशलम	जेरसस्ल
yorker	यॉर्कर	यॉर्कर
yojanaein	योजनाएं	योजनाएं
yojanaen	योजनाएं	योजनाएं
yojanaye	योजनाएं	योजनाए
rangate	रंगते	रंगते
rangte	रंगते	रंंटे
rangkata	रंजकता	रंगकता
ranjkatha	रंजकता	रंंकता
ranjkta	रंजकता	रंंकतत
raees	रईस	राइस
rais	रईस	रास
raktaabh	रक्ताभ	रक्तभ
raktabh	रक्ताभ	रक्तभ
rakhna	रखना	रखना
raghupati	रघुपति	रघुपती
raghuram	रघुराम	रघुरमम
registerd	रजिस्टर्ड	रिजस््ररड
registered	रजिस्टर्ड	रिजस््रेेड
ratanpur	रतनपुर	रतनपपुर
runners	रनर्स	रननर््
rayan	रयान	राय
ryan	रयान	रायन
ralhan	रल्हन	रल्हन
ravish	रविश	रािश
ravael	रवैल	रवाल
ravel	रवैल	रावल
rawail	रवैल	रावल
rasad	रसद	रसद
rasaayanik	रसायनिक	रसायननिक
rasaayanika	रसायनिक	रसायननिका
rasayanika	रसायनिक	रसायननिका
rasyanik	रसायनिक	रसस्यािक
rasaayanon	रसायनों	रसायनों
rasayanon	रसायनों	रसायनों
rahamat	रहमत	रहमत
rahmat	रहमत	रहमत
rhamat	रहमत	रहमत
rahenge	रहेंगे	राेंगे
rahegi	रहेगी	रहईगी
rounder	राउंडर	राउडडर
raak	राक	राक
rak	राक	रकक
raakhe	राखे	राखे
rakhe	राखे	रखे
raagon	रागों	रागों
ragon	रागों	रगगों
raghavan	राघवन	रघवान
raaj	राज	राज
raj	राज	राज़
rajkot	राजकोट	राजकोट
rajtantra	राजतंत्र	राजतंत्र
raajneetikaran	राजनीतीकरण	राजनीतिकरण
rajneetikaran	राजनीतीकरण	राजनीतिकरण
rajnitikaran	राजनीतीकरण	राजनीतिकरण
rajma	राजमां	राजमा
rajman	राजमां	राजमान
raajasva	राजस्व	राजसाव
rajasva	राजस्व	राजसाव
raaji	राजी	राजी
raji	राजी	राजी
rajinaama	राजीनामा	राजिनमा
rajinama	राजीनामा	राजिनमा
raajon	राजों	राजों
rajon	राजों	राजों
rana	राणा	राना
raatrichar	रात्रिचर	रात्रिचा
ratrichar	रात्रिचर	रत्रिचर
raadhe	राधे	राडे
radhe	राधे	रे़े
ranapur	रानापुर	रानपुर
rabin	राबिन	रबीि
robin	राबिन	रॉबिन
rabha	राभा	राा
ramkot	रामकोट	रामकोट
ramkote	रामकोट	रामकोट
ramtek	रामटेक	रामेेक
rampur	रामपुर	रामपुर
rambharose	रामभरोसे	रामभारस
rambharosey	रामभरोसे	रामभरेसी
ramraj	रामराज	रामराज
raalod	रालोद	रालोड
ralaud	रालोद	रालौड
ralod	रालोद	रालोड
ravaley	रावले	रवाले
ravle	रावले	रावल
rasayanik	रासायनिक	रससयननिक
racreation	रिक्रिएशन	राक्रशनन
recreation	रिक्रिएशन	रिक्रेशन
rig	रिग	राग
riggs	रिग्स	रिग्स
rigs	रिग्स	रिज्स
richual	रिचुअल	रिचुअल
ritual	रिचुअल	ऋतुटल
reduction	रिडक्शन	रेडकक्शन
ripan	रिपन	रिपन
ripon	रिपन	रिपों
ria	रिया	राई
riya	रिया	रिया
rishte	रिश्ते	ऋषश्त
rishtey	रिश्ते	रिश्ते
risane	रिसने	रिसने
risaney	रिसने	रिसने
risne	रिसने	रिजने
rihana	रिहाना	रिहाा
rihanna	रिहाना	रिहनना
regal	रीगल	रेगल
rigal	रीगल	रिगल
reasonal	रीजनल	रिस्नल
regional	रीजनल	रेजोनिल
retreate	रीट्वीट	रिट्रेटट
retweet	रीट्वीट	रेटववट
reeta	रीता	रीता
rita	रीता	रतता
rukate	रुकते	रुकते
rukte	रुकते	रुकते
ruktey	रुकते	रुकते
rugan	रुग्ण	रूगन
rugna	रुग्ण	रुग्ण
ruganta	रुग्णता	रूगगता
rugnata	रुग्णता	रूगनतता
rojvelt	रुजवेल्ट	रुजवेल्ट
roojwelt	रुजवेल्ट	रुजवेल्ट
roosevelt	रुजवेल्ट	रूसवेलेट
rodolph	रुडोल्फ	रोडोप्
rudolf	रुडोल्फ	रुडोल्फ
rudolph	रुडोल्फ	रूड़ल्प
roopesh	रुपेश	रूपे
rupesh	रुपेश	रूपे
ruby	रुबी	रूब
roomani	रुमानी	रूमानी
rumani	रुमानी	रूमाी
rukavaton	रूकावटों	रुकावतों
root	रूट	रूट
route	रूट	राउट
rooting	रूटिंग	रूटनिग
routine	रूटिंग	रूउटे
routing	रूटिंग	रोटनंग
roots	रूट्स	रूट्स
routes	रूट्स	राउट्स
roopak	रूपक	रूपक
rupak	रूपक	रूपक
roopi	रूपी	रूपी
rupi	रूपी	रूपी
rantle	रेंटल	रंंले
rental	रेंटल	रेंटल
registan	रेगिस्तान	रेजिस्टन
registani	रेगिस्तानी	रेजसस्टीन
reja	रेजा	रेजा
reza	रेजा	रेजा
rate	रेट	राते
rate	रेत	राते
ret	रेत	रेट
refaeli	रेफेली	रेफली
refeli	रेफेली	रेफली
reshe	रेशे	रेशे
reshey	रेशे	रेशे
race	रेस	रेस
rese	रेस	रेज
racer	रेसर	रेसर
recer	रेसर	रिसर
racing	रेसिंग	रेसिंग
reson	रेसों	रेसोन
rehaana	रेहाना	रिहाा
rehana	रेहाना	रेहाा
racketeer	रैकेटियर	रैकेटियर
racketier	रैकेटियर	रेकीटर
rectare	रैकेटियर	रिक्टर
radical	रैडिकल	रेडिकल
raidical	रैडिकल	राडडिक
raith	रैथ	रैठ
rapping	रैपिंग	रापिंग
wrapping	रैपिंग	व्प््ििग
robertsan	रॉबर्टसन	रॉबर्ट्नन
robertson	रॉबर्टसन	रॉबर्ट्न
robinson	रॉबिंसन	रॉबिननन
royals	रॉयल्स	रॉयल्स
rojlin	रोजलिन	रोजलिन
rozlyn	रोजलिन	रोजलिन
rotation	रोटेशन	रोटनशन
rodrigo	रोड्रिगो	रोड़िगग
ronaldo	रोनाल्डो	रोनाल्डो
ronit	रोनित	रोनिट
roni	रोनी	रोनी
ropane	रोपने	रोपने
ropaney	रोपने	रोपने
ropne	रोपने	रोपने
robin	रोबिन	रोबिन
roya	रोया	रोया
rollers	रोलर्स	रोलर्स
rovan	रोवन	रोवन
rowan	रोवन	रोवन
rosario	रोसारियो	रोसरियो
rosariyo	रोसारियो	रोसरियों
raubadaar	रौबदार	रौबाार
raubadar	रौबदार	रौबदार
raubdar	रौबदार	राबद्र
landara	लंगड़ा	लंदरा
langada	लंगड़ा	लंगड़ा
langda	लंगड़ा	लंंडड
langar	लंगर	लंंर
langaron	लंगरों	लंगगरों
langron	लंगरों	लंंगरों
lambi	लंबी	लांबी
lakeer	लकीर	लाकर
lakir	लकीर	लाकर
lakiron	लकीरों	लककरों
lakme	लक्मे	लकके
lakshmidhar	लक्ष्मीधर	लक्ष्मीधार
lakshmighar	लक्ष्मीधर	लक्ष्मीहार
lakshy	लक्ष्य	लक्ष्य
lakshya	लक्ष्य	लक्ष्य
lakshyon	लक्ष्यों	लक्ष्यों
lux	लक्स	लक्स
laksar	लक्सर	लक्सर
luxor	लक्सर	लक्सर
lakhkhi	लख्खी	लख्खी
lagna	लगना	लगना
laganewale	लगनेवाले	लगाेेवले
lagnevaaley	लगनेवाले	लगनेवाले
lagnewale	लगनेवाले	लगनेवाले
lagega	लगेगा	लगेगा
lajjalu	लज्जालु	लजज्लू
latkate	लटकाते	लटकते
ladki	लड़की	लड़की
ladate	लड़ते	लड़ते
ladte	लड़ते	लड़ते
ladaai	लड़ाई	लड़ईई
ladai	लड़ाई	लड़ाई
ladaaiyon	लड़ाईयों	लडााययों
ladaeyon	लड़ाईयों	लड़ाईयों
ladaiyon	लड़ाईयों	लड़ायों
lapetane	लपेटने	लपपटने
lapetne	लपेटने	लपपटने
labada	लबादा	लबबाा
lbada	लबादा	लबाड़
labdh	लब्ध	ला्भ
lbdh	लब्ध	एलबी
lalak	ललक	लाक
lalkarata	ललकारता	ललकररता
lalkarta	ललकारता	लाककरता
lalla	लल्ला	लललल
lavasa	लवासा	लवासा
lovasa	लवासा	लोवाा
lassi	लस्सी	लस्सी
lahanaa	लहना	लहना
lahna	लहना	लहना
lehna	लहना	लहना
lahraee	लहराई	लहराई
lahrai	लहराई	लहराई
lehrayi	लहराई	लहरायी
lahalhati	लहलहाती	लहलाती
lahlahaati	लहलहाती	लहहााती
lahlahati	लहलहाती	लहहााती
lahsun	लहसुन	लहसूओ
lasoon	लहसुन	लसूओं
lanchar	लांचर	लांचर
launcher	लांचर	लांचर
lycopene	लाइकोपिन	लापोनन
lime	लाइम	लाइम
lives	लाइव्स	लाइवस
live	लाईव	लाइव
laegi	लाएगी	लागी
lagataar	लागातार	लगातर
lagatar	लागातार	लगात
laata	लाता	लाता
lata	लाता	लटा
laati	लाती	लाटी
lati	लाती	लाी
layega	लायेगा	लायगा
lalpur	लालपुर	ललपपर
las	लास्ट	लास
last	लास्ट	लस्ट
lindbhed	लिंगभेद	लिंदबेड
lingbhed	लिंगभेद	लिंगबेड
lindan	लिंडन	लिंडन
lindn	लिंडन	लिंडन
lindon	लिंडन	लिंडों
likhakar	लिखकर	लिखकर
likhkar	लिखकर	लिखकर
ligar	लिगर	लिगर
liger	लिगर	लाइजर
liberation	लिबरेशन	लाइब्रेशन
libration	लिबरेशन	लाइब्रेशन
liberation	लिब्रेशन	लाइब्रेशन
libration	लिब्रेशन	लाइब्रेशन
leaderon	लीडरों	लीडरों
leedaron	लीडरों	लीडरां
lidaron	लीडरों	लिइडरों
liidaron	लीडरों	लिइडरों
louis	लुईस	लॉयस
luis	लुईस	लास
ludhakate	लुढ़कते	लुढ़कते
ludhkate	लुढ़कते	लुडककते
lurhakate	लुढ़कते	लुऱकते
lutf	लुत्फ	लुट
lumding	लुमडिंग	लंंििंग
lootmaar	लूटमार	लूटमार
lootmar	लूटमार	लूटमार
landal	लेंडल	लंडल
lendal	लेंडल	लेंडल
lega	लेगा	लेगा
legaa	लेगा	लेगा
letakar	लेटकर	लेटाक
letkar	लेटकर	लेटकर
lenevali	लेनेवाली	लेनेवाली
lenewali	लेनेवाली	लेनेवाली
label	लेबल	लेबल
labeling	लेबलिंग	लेबिंग
labelling	लेबलिंग	लेबिंगंग
labelo	लेबलों	लेबलो
labelon	लेबलों	लेबलों
lebalon	लेबलों	लेबालों
lemon	लेमन	लेमोन
laingadan	लैंगडन	लैंगगान
langdon	लैंगडन	लंंगडों
lengdan	लैंगडन	लेंगान
laigikata	लैंगिकता	लागिकता
laingikta	लैंगिकता	लैंगिकता
lanset	लैंसेट	लंंसट
lenset	लैंसेट	लेंसेट
lairi	लैरी	लारी
lairy	लैरी	लैरी
larry	लैरी	लारी
lace	लैस	लेस
less	लैस	लेस
locket	लॉकेट	लॉकेट
laundry	लॉन्ड्री	लॉंडरी
longewal	लोंगोवाल	लोंगेवलल
longewala	लोंगोवाल	लोंगेवाल
longoval	लोंगोवाल	लोंगनवाल
log	लोग	लोग
loge	लोगे	लोग
lochdar	लोचदार	लोचडार
lodi	लोदी	लॉडी
laurence	लौरेंस	लौरेंस
laurens	लौरेंस	लॉरेंस
laurense	लौरेंस	लॉरेंस
wonder	वंडर	वंडर
vansh	वंश	वंश
vanshdhar	वंशधर	वंशधार
vanshavad	वंशवाद	वंश्वद
vanshvaad	वंशवाद	वंश्वाद
vanshvad	वंशवाद	वंश्वद
wanshwad	वंशवाद	वंश्वदद
vajood	वजूद	वजूद
vajud	वजूद	वाजूद
wajood	वजूद	वजूद
vadali	वडाली	वाली
vadli	वडाली	वाली
wadali	वडाली	वाली
vanita	वनिता	वानिता
vareinye	वरेण्य	वररननी
varenya	वरेण्य	वररनन
varn	वर्ण	वर्ण
varna	वर्ण	वर्ा
varnit	वर्णित	वर्ीत
vartamaan	वर्तमान	वर््मान
vartaman	वर्तमान	वर््मान
vartmaan	वर्तमान	वर््तान
vartman	वर्तमान	वर््तान
varddhaman	वर्द्धमान	वर्दमान
vardhmaan	वर्द्धमान	वर्भमान
vardhman	वर्द्धमान	वर्धमान
verbal	वर्बल	वर्बल
varshan	वर्शन	वर्षण
vasharan	वर्शन	वराषण
vershan	वर्शन	वर्शन
version	वर्शन	वर्सियो
varsaache	वर्साचे	वर्शाचे
varsaryache	वर्साचे	वर्साचे
vasearche	वर्साचे	वसेरेचे
valkan	वल्कन	वल्कन
valkkan	वल्कन	वाक्कक
velkan	वल्कन	वेलकन
vash	वश	वाष
vashikaran	वशीकरण	वशषषकरण
vaangchuk	वांगचुक	वांमकुक
vangchuk	वांगचुक	वंगकुक
wangchuk	वांगचुक	वंगकुक
want	वांट	वैंट
vije	वाइज	वाजज
vise	वाइज	वाइस
wise	वाइज	वाइज
vatar	वाटर	वार
water	वाटर	वाटर
watson	वाटसन	वाटसन
wattson	वाटसन	वाटट्सो
vaan	वाण	वान
waan	वाण	वान
vaanon	वाणों	वानों
vanon	वाणों	वनों
wanon	वाणों	वननों
vatanukulan	वातानुकूलन	वाटननुल्ल
watanukoollan	वातानुकूलन	वाटननुल्ल्
vaadak	वादक	वादक
vadak	वादक	वडकक
vaadiyon	वादियों	वादियों
vadiyon	वादियों	वादियों
wadiyon	वादियों	वादियों
vayana	वायना	वययना
vayna	वायना	वायना
wayna	वायना	वानन
wireless	वायरलेस	वायेल्स
wirerless	वायरलेस	वाररेल्स
warrior	वारियर्स	वररीर
warriors	वारियर्स	वरर्र्स
valve	वाल्व	वाले
wolv	वाल्व	वॉल्व
vastavik	वास्तविक	वास्त्विक
vastvik	वास्तविक	वास्तविक
vaahikayen	वाहिकाएं	वाहिकाएं
vahikayen	वाहिकाएं	वहीककाएं
wahikayan	वाहिकाएं	वहहककां
winter	विंटर	विंटर
vincent	विंसेंट	विंकेंट
vikalpon	विकल्पों	विकललपों
wicket	विकेट	विकेट
vikramjeet	विक्रमजीत	विक्रजितत
vikramjit	विक्रमजीत	विक्रमजीत
vichaarakon	विचारकों	विचारकों
vicharakon	विचारकों	विचारकों
vigyan	विज्ञान	विज्ञान
vigyaani	विज्ञानी	विज्ञानी
vigyani	विज्ञानी	विज्ञान
vigyaanon	विज्ञानों	विज्ञानों
vigyanon	विज्ञानों	विज्ञानों
vitthal	विट्ठल	वित्तल
viththal	विठ्ठल	विठतलल
vitthal	विठ्ठल	वित्तल
vitark	वितर्क	वितर्क
vidhaaein	विद्याएं	विधाएं
vidyaayein	विद्याएं	विद्याएं
vidyaen	विद्याएं	विद्याएं
vidhaaon	विद्याओं	विधाओं
vidyaaon	विद्याओं	विद्याओं
vidyaon	विद्याओं	विद्याओं
vidhansabhaein	विधानसभाएं	विधामेंााएं
vidhansabhaen	विधानसभाएं	विधानेभााएं
vidhivat	विधिवत	विधिवत
vidhut	विधुत	विद्युत
vinasht	विनष्ट	विनाष्ट
vineet	विनीत	विनीत
vinit	विनीत	विनित
vipreetataa	विपरीतता	विपरतततता
vipritata	विपरीतता	विपरीतता
vipra	विप्रा	विपरा
vipro	विप्रो	विपरो
wipro	विप्रो	विइरो
vibha	विभा	विभा
vibhajak	विभाजक	विभाजक
vibhram	विभ्रम	विभ्रम
vibhrm	विभ्रम	विभ््म
vibram	विभ्रम	विइब्रम
vimarsh	विमर्श	विमर्श
vimarsho	विमर्शों	विमर्शो
vimarshon	विमर्शों	विमर्शों
virajati	विराजती	विराजी
virechan	विरेचन	वीरेचन
virodh	विरोध	विरोध
virodhabhasi	विरोधाभासी	विरोभाासी
virodhabhason	विरोधाभासों	विरोधाभासों
vividh	विविध	विविध
vivekahin	विवेकहीन	विवेकाहीन
vivekheen	विवेकहीन	विवेचीन
visheshan	विशेषण	विशेषण
visheshanon	विशेषणों	विशेषनों
visheshaadhikaar	विशेषाधिकार	विशेषाधिकार
visheshadhikar	विशेषाधिकार	विशेषाधिकार
vishwasaniy	विश्वसनीय	विश्वससीय
vishwasniiya	विश्वसनीय	विश्वससीय
vishwasaniyata	विश्वसनीयता	विश्वसस्यतत
vishwasniiyataa	विश्वसनीयता	विश्वस्नियता
vishahin	विषहीन	विशाहीन
vishhin	विषहीन	विश्न
vishanu	विष्णु	विषाणु
vishnu	विष्णु	विष्णु
vlc	वीएलसी	व्लीसी
weeks	वीक्स	विक्स
veerchand	वीरचंद	वीरचंद
virchand	वीरचंद	विरचंंद
veeresh	वीरेश	वीरेश
viresh	वीरेश	वारेश
vritton	वृत्तों	वृत्तों
vruton	वृत्तों	व्तोोो
vrutton	वृत्तों	वृत्तों
venkataraman	वेंकटरमन	वेंकटरमान
venkatraman	वेंकटरमन	वेंकट्रमम
ved	वेड	वेड
wade	वेड	वेड
wed	वेड	वेड
wedding	वेडिंग	वेडडिंग
vediyon	वेदियों	वेदियों
vedon	वेदों	वेडोों
venezuela	वेनेजुएला	वेनेजलला
veronica	वेरोनिका	वररोनिका
veronika	वेरोनिका	वररोनिका
weronika	वेरोनिका	वररननिका
velvet	वेलवेट	वेलवेट
welwet	वेलवेट	वेलवेट
welder	वेल्डर	वेल्डर
weldor	वेल्डर	वेल्डर
welding	वेल्डिंग	वेलिंग
wealth	वेल्थ	वेल्ठ
vellur	वेल्लूर	वेल्यु
velur	वेल्लूर	वेल्र
vesh	वेश	वेश
wasting	वेस्टिंग	वास्टिंग
westing	वेस्टिंग	वेस्टिंग
wastinghouse	वेस्टिंगहाउस	वास्टममिस
westinghouse	वेस्टिंगहाउस	वेस्टिननस
vaisley	वेस्ले	वेस्ले
vesle	वेस्ले	वेसलल
wesle	वेस्ले	वेसले
vaigyaanik	वैज्ञानिक	वैज्ञानिक
vaigyanik	वैज्ञानिक	वैज्ञािि
vegyanik	वैज्ञानिक	वेज्ञानिक
vaigyaanikta	वैज्ञानिकता	वैज्ञानिकता
vaigyanikata	वैज्ञानिकता	वैग्ञाििकता
vaigyanikta	वैज्ञानिकता	वैज्ञाििकता
vaitravati	वैत्रवती	वैत्रवती
vaitrawati	वैत्रवती	वैत्रवती
vaimanasy	वैमनस्य	वैमानसे
vaimanasya	वैमनस्य	वैमननसयय
vaimanya	वैमनस्य	वैमनन्य
very	वैरी	वेरी
vaisaakh	वैशाख	वैसाख
vaishakh	वैशाख	वैशा
vaishaakhi	वैशाखी	वैशाखी
vaishakhi	वैशाखी	वैशाची
vaishnodevi	वैष्णोदेवी	वैष्णोदेवी
vyaktigat	व्यक्तिगत	व्यक्तिगत
vyagr	व्यग्र	व्यग्र
vyagra	व्यग्र	व्याग्र
vyatit	व्यतीत	व्यत्तत
vytit	व्यतीत	व्यतित
vyabhichar	व्यभिचार	व्याभिचा
vyabhichari	व्यभिचार	व्याभिचारी
vyavadhan	व्यवधान	व्यवधाधन
vyavdhan	व्यवधान	व्यवधान
vyavahargat	व्यवहारगत	व्यवरारमत
vyvhargat	व्यवहारगत	व्यवररगत
vyaghat	व्याघात	व्याघत
vyapak	व्यापक	व्यापक
vlad	व्लाद	व्लाद
wlaad	व्लाद	व्लाड
vladimir	व्लादिमीर	व्लाधिमार
shanghai	शंघाई	शांाईई
shatpath	शतपथ	शतपथ
shanivar	शनिवार	शनिवार
shaniwar	शनिवार	शाननवर
shabana	शबाना	शबाना
shbana	शबाना	शबाना
shabdarth	शब्दार्थ	शब्दर्थ
shamadan	शमादान	शमादन
shmadan	शमादान	शममान
shamitabh	शमिताभ	शमीतमभ
shamil	शमिल	शमील
shmil	शमिल	शमील
sharabon	शराबों	शराबों
shrabon	शराबों	शरबबों
shararat	शरारत	शरारत
shrart	शरारत	श्रृत
sharmana	शर्माना	शरममना
shaharwasiyon	शहरवासियों	शहरवसससियों
shahrvasiyon	शहरवासियों	शहर्वससियों
shervasiyon	शहरवासियों	शेरवासियों
shahdara	शहादरा	शहदारा
shaantikaal	शांतिकाल	शांतिकाल
shantikal	शांतिकाल	शांतिका
shaao	शाओ	शाओ
shao	शाओ	शाओ
shaakir	शाकिर	शाकीर
shakir	शाकिर	शकीक
shaakhaaen	शाखाएं	शाखाएं
shakhayan	शाखाएं	शखाया
shakhayen	शाखाएं	शखाएंं
shayak	शायक	शायक
shaavakon	शावकों	शावकों
shavakon	शावकों	शववकों
shavkon	शावकों	शावकों
shaasaka	शासक	शासका
shasak	शासक	शासक
sasakon	शासकों	ससकों
shaasakon	शासकों	शासकों
shasakon	शासकों	शाककों
shipra	शिप्रा	शिपरा
shirke	शिर्के	शिरके
sheershakon	शीर्षकों	शीर्षकों
shirshakon	शीर्षकों	शिर्षकों
shirshkon	शीर्षकों	शिर्षकों
shujaat	शुजात	शुजात
shujat	शुजात	शूजत
shooting	शुटिंग	शूटिंग
shutting	शुटिंग	शूटटिंग
should	शुड	शाल्ड
shud	शुड	शूद
shubhankar	शुभंकर	शुभंकर
shumaali	शुमाली	शुमाली
shumali	शुमाली	शुमाली
shringaar	शृंगार	श्रगंगर
shringar	शृंगार	श्रृंग
shrungar	शृंगार	श्ंगगर
sheling	शेलिंग	शेलिंग
shelling	शेलिंग	शेलिंग
shaili	शैली	शैली
shaly	शैली	शल्य
sheli	शैली	शेली
shaishav	शैशव	शैशाव
sean	शॉन	सीन
shaun	शॉन	शौन
shawn	शॉन	शाव
short	शोर्ट	शोर्ट
sure	श्योर	सुरे
shrankhala	श्रंखला	श्रंंखल
shrankhalaa	श्रंखला	श्रंखला
shrunkhla	श्रंखला	शृंखला
shrankhalaaon	श्रंखलाओं	श्रंखललओओं
shrinkhalaon	श्रंखलाओं	श्रखंखलाओं
shrunkhlaon	श्रंखलाओं	शृंखलाओं
shravani	श्रावणी	श्रावनी
shrikar	श्रीकर	श्रीकर
shrikhand	श्रीखंड	श्रीखंद
shrimati	श्रीमति	श्रीमती
shriram	श्रीराम	श्रीमम
sriram	श्रीराम	श्रीमम
shrotaon	श्रोताओं	श्रोताओं
shat	षट्	शत
sankhyaein	संख्याएं	संख्याएं
sankhyaen	संख्याएं	संख्याएं
sankhyayen	संख्याएं	संख्याएं
sanghanit	संघनित	संघानित
sanghnit	संघनित	संघनित
sanchayan	संचयन	संचाया
sanchar	संचार	संचार
sanchaari	संचारी	संचारी
sanchari	संचारी	संचारी
sanchalanon	संचालनों	संचालनों
sanchalnon	संचालनों	संचालोों
sanjay	संजय	संजय
sanjeevan	संजीवन	संजीवन
sanjivan	संजीवन	संजीवन
santati	संतति	संतति
sandarbh	संदर्भ	संदर्भ
sandarbha	संदर्भ	संदर्भ
sandrbh	संदर्भ	संं््भ
sandarbhon	संदर्भों	संदररहों
sandrbhon	संदर्भों	संद्रभों
sandali	संदली	संडली
sandli	संदली	संंली
sandhan	संधान	संधन
samprati	संप्रति	संप्रति
samprti	संप्रति	संप््ति
samprabhu	संप्रभु	संप्रभू
samprbhu	संप्रभु	संप्रभू
samprabhuta	संप्रभुता	संप्रभूता
samprbhuta	संप्रभुता	संप्रभतता
sambit	संबित	संबित
sambhalane	संभालने	संभालने
sambhalne	संभालने	संभालेे
sambhrant	संभ्रांत	संभारंत
sanbharnt	संभ्रांत	संभार्त
sanyog	संयुक्त	सनयोग
sanyukt	संयुक्त	सननुक््
sanyukta	संयुक्त	सननुक्तत
sanyukta	संयुक्ता	सननुक्तत
sanyogvash	संयोगवश	संयोग्वाश
sanyojan	संयोजन	संयोजन
sanyojanon	संयोजनों	संयोजजनों
sanyojnon	संयोजनों	सनयोजजनों
samvedikaran	संवेदीकरण	संवेद्कीरण
sanvedikaran	संवेदीकरण	संवेद्रीकण
samshayon	संशयों	समश्यों
sanshayon	संशयों	संशायों
sanshyon	संशयों	संश्यों
sanskaar	संस्कार	संस्कर
sanskar	संस्कार	संस्क
sanskaari	संस्कारी	संस्कारी
sanskari	संस्कारी	संससकार
sanskrit	संस्कृत	संस्कृत
sanskurt	संस्कृत	संस्कृत
sanskritiyan	संस्कृतियां	संस्कृतियां
sanskrutiyan	संस्कृतियां	संस्कृतियां
sanskritiyon	संस्कृतियों	संस्कृतियों
sanskrutiyon	संस्कृतियों	संस्कृतियों
sanasthit	संस्थित	सनस््थित
sansthit	संस्थित	संस्थित
sanasthita	संस्थिता	सनस््थित
sansthita	संस्थिता	संस्थिता
sakara	सकरा	सकरा
sakra	सकरा	सकरा
sakshan	सक्शन	सक्षण
suction	सक्शन	सक्टनन
sacchidanand	सच्चिदानंद	सच्चंदंंद
sachhidanand	सच्चिदानंद	सच्छांंद
sachidanand	सच्चिदानंद	सचिचंंद
sajja	सज्जा	सजजज
sat	सत	सात
satpal	सतपाल	सतपाल
satluj	सतलुज	सतलूज
sataane	सताने	सताने
satane	सताने	सतने
sate	सते	सेते
satti	सत्ती	सत्ती
satvat	सत्वत	सतववत
sadanand	सदानंद	सदानंद
sapane	सपने	सपने
sapne	सपने	सापे
sapney	सपने	सपने
saparivaar	सपरिवार	सपररवार
sapariwar	सपरिवार	सपररवार
sparivar	सपरिवार	स्पररवर
sapaat	सपाट	सपात
sapat	सपाट	सपतत
sapate	सपाटे	सपते
sapatey	सपाटे	सपतत
saptakranti	सप्तक्रांति	सप्तकररतति
saptkraanti	सप्तक्रांति	सप्तकररतति
saptapadi	सप्तपदी	सप्तपाादी
saptpadi	सप्तपदी	सप्तपादी
saptari	सप्तरी	सप्तरी
sapramaan	सप्रमाण	सप्रमान
sapraman	सप्रमाण	सप्रमान
submit	सबमिट	सब्मित
sabmission	सबमिशन	सब्मिसन
submission	सबमिशन	सब्मिसन
sabhaein	सभाएं	सभाएं
sabhaen	सभाएं	सभाएं
sabhayen	सभाएं	सभाएं
sabhen	सभाएं	सभें
sabhasadon	सभासदों	सभासाोों
sabhyata	सभ्यता	सभ्यता
samjhoonga	समझूंगा	समझूगगा
samjhunga	समझूंगा	समझूगा
samjhungaa	समझूंगा	समझूगा
saman	समन	सममन
samanvayaka	समन्वयक	समननवययक
samanwayaka	समन्वयक	समननवायक
samnvyak	समन्वयक	समन्वायक
samaadhaan	समाधान	समाधा
samadhan	समाधान	समाधन
samadhiyon	समाधियों	समाधियों
samadjiyon	समाधियों	समाज्ियों
samalakha	समालखा	समलला
samalakhaa	समालखा	समलखा
samahaar	समाहार	समाहार
samahar	समाहार	समाहा
samitiyan	समितियां	समीतियां
sametati	समेटती	समेटती
sametti	समेटती	समेत्ी
sarka	सरका	सरका
sarkaa	सरका	सरका
sarkarein	सरकारें	सरकरने
sarkaren	सरकारें	सरकरने
sarkaaron	सरकारों	सरकारों
sarkaron	सरकारों	सरकररों
sargana	सरगना	सरगना
sarganaon	सरगनाओं	सरगगणाओं
sargi	सरगी	सर्गी
sarguja	सरगुजा	सरगुजज
sarjuga	सरगुजा	सरजुगा
sarsa	सरसा	सरसा
sarsaa	सरसा	सरसा
sarahind	सरहिंद	साहींद
sarhind	सरहिंद	साहींद
sirhind	सरहिंद	सीर्ंंद
saraaha	सराहा	सराहा
saraha	सराहा	सरहह
saraahi	सराही	सराही
sarahi	सराही	सरहही
salaahkar	सलाहकार	सलाहकर
salahkaar	सलाहकार	सलाहकार
salahkar	सलाहकार	सलाहकर
saleeb	सलीब	सलीब
salib	सलीब	सालब
select	सलेक्ट	सलेक्ट
saltanat	सल्तनत	सललतनत
saltnat	सल्तनत	सलल्ना
savaal	सवाल	सवाल
saval	सवाल	सवलल
sawaal	सवाल	सवाल
sawal	सवाल	सवलल
sahakalaakar	सहकलाकार	सहकालकर
sahakalakar	सहकलाकार	सहकालकर
sahkalakar	सहकलाकार	सहकालकर
sahadev	सहदेव	सहादे
sahdev	सहदेव	सहदेव
sahrawat	सहरावत	सहरावत
sherawat	सहरावत	शेरावत
sahooliyata	सहूलियत	सहूलियता
sahuliyat	सहूलियत	सहूलियत
sahuuliyata	सहूलियत	सहूलियता
saanketika	सांकेतिक	सांकककिका
sanketik	सांकेतिक	संकेटकक
saimans	साइमंस	सैमांस
simmons	साइमंस	साइमंस
symons	साइमंस	साइमंस
saima	साइमा	सैमा
sagarika	सागरिका	सगररकक
sagrika	सागरिका	सग्रकका
saga	सागा	सागा
saajan	साजन	साजन
sajan	साजन	सजा
saajsajja	साजसज्जा	साजसजजज
sajsajja	साजसज्जा	साजसजजज
saja	साजा	सजा
saathsaath	साथसाथ	साथ्था
sathsath	साथसाथ	सत्था
sathiya	साथिया	साथयय
saabah	साबाह	साबा
sabah	साबाह	साबाह
samanjasy	सामंजस्य	समाजजाय
samanjasya	सामंजस्य	समाजजायय
samoa	सामोआ	समो
samoaa	सामोआ	सामोआ
saayn	सायं	साय
sayan	सायं	सायं
saym	सायं	सायम
saira	सायरा	सैरा
sayara	सायरा	सयारा
sayra	सायरा	सायर
salve	साल्वे	सलवे
sahab	साहब	सहाब
singapore	सिंगापुर	सिंगपपोर
singaar	सिंगार	सिंगर
singar	सिंगार	सिंगर
singer	सिंगार	सांगर
singhaadey	सिंघाड़े	सिंहाेे
singhade	सिंघाड़े	सिंहाेे
singhde	सिंघाड़े	सिंघाड़े
singhre	सिंघाड़े	सिंघाड़े
singhi	सिंघी	सिंही
singha	सिंहा	सिंहा
sinha	सिंहा	सिंहा
siera	सिएरा	सियर
sierra	सिएरा	सिररा
sikud	सिकुड़	सिकुड
signals	सिगनल्स	सिगनेल्स
cigaretton	सिगरेटों	कागग्ट्टन
cigretton	सिगरेटों	साग््ट्नन
siddhivat	सिद्धवट	सिद्धितत
siddhvat	सिद्धवट	सिद्धतत
siddhwat	सिद्धवट	सिद्धतत
sinabang	सिनाबंग	सिनाबंग
synapse	सिनेप्स	साननपसस
sipah	सिपाह	सिपाह
sipaha	सिपाह	सिपाह
sipahiyon	सिपाहियों	सिपाहियों
sipahi	सिपाही	सिपाही
sim	सिम	सीमम
simat	सिमट	सिमट
simatataa	सिमटता	सिमतता
simatta	सिमटता	सिमतता
simtata	सिमटता	सिंटता
simtataa	सिमटता	सिंटता
cement	सिमटे	सीमेंट
simate	सिमटे	सिमटे
simi	सिमी	सिमी
simmy	सिमी	सिम्ी
sims	सिम्स	सिम्स
siyasi	सियासी	सियाी
siyah	सियाह	सिया
siyaha	सियाह	सियाह
sirpur	सिरपुर	सिरपुर
sivan	सिवान	सिवन
siwan	सिवान	सिवन
sisva	सिसवा	सिसवा
siswa	सिसवा	सिसवा
cil	सीआईएल	सील
csi	सीएसआई	सीसीआई
sikar	सीकर	सिकर
seaten	सीटें	सीटें
sitaram	सीताराम	सीतरर
sitaharan	सीताहरण	सीताहरण
cpm	सीपीएम	सीपीएम
cps	सीपीएस	सीपीएस
cbse	सीबीएसई	सीबीएस
seem	सीम	सीम
sim	सीम	सीम
sealed	सील्ड	सीलेड
shield	सील्ड	शील्ड
ccd	सीसीडी	सीसीडी
sugamata	सुगमता	सुगमतत
sugmta	सुगमता	सुग्ता
sujan	सुजेन	सुजन
sujen	सुजेन	सुजें
suken	सुजेन	सूकें
sujain	सुजैन	सुजाएं
sujhaati	सुझाती	सुझाती
sujhati	सुझाती	सुझाती
sutali	सुतली	सूतली
sutli	सुतली	सूटली
suta	सुता	सूता
sdueep	सुदीप	स्वूप
sudip	सुदीप	सुडीप
sudhaargrah	सुधारगृह	सुधारगृह
sudhargrih	सुधारगृह	सुधार्धि
sudhargruh	सुधारगृह	सुधारगगह
sunaaron	सुनारों	सुनारों
sunaron	सुनारों	सुनारों
sunaseer	सुनासीर	सुनासी
sunasir	सुनासीर	सुनासी
suneeti	सुनीति	सुनीति
suniti	सुनीति	सुनीति
sunega	सुनेगा	सुनेगा
suneyga	सुनेगा	सुनेगा
superhit	सुपरहिट	सुपररहत
supachy	सुपाच्य	सुपच्
supachya	सुपाच्य	सुपच्य
supachye	सुपाच्य	सुपचाय
subhaay	सुभाय	सुभाए
subhay	सुभाय	सुभा
surveen	सुरवीन	सर्वीन
survin	सुरवीन	सर्वीन
surana	सुराणा	सुरना
sulkhan	सुलखान	सुलखान
suljaayi	सुलझाई	सुलझाई
suljayi	सुलझाई	सुलझाई
suljhai	सुलझाई	सुलझाई
sulzai	सुलझाई	सुलझाई
sultana	सुलताना	सुल्तना
sulaati	सुलाती	सुलाती
sulati	सुलाती	सुलती
susanskrit	सुसंस्कृत	सुसंसककृत
susanskrut	सुसंस्कृत	सुसंसकृत
suhagin	सुहागिन	सुहागी
soond	सूंड़	सूंड
sund	सूंड़	संंड
suiyan	सूइयां	सुयाए
sukhati	सूखती	सूखती
sukhti	सूखती	सूखती
sukhakar	सूखाकर	सुखकक
soochak	सूचक	सूचक
suchak	सूचक	सूचक
sooja	सूजा	सूजा
suja	सूजा	सुजा
suba	सूबा	सूबा
sube	सूबे	सुबे
sooraj	सूरज	सूरज
suraj	सूरज	सुरज
surinaam	सूरीनाम	सुरिनाम
surinama	सूरीनाम	सुरिन्मा
suriname	सूरीनाम	सुरीनेम
suryadev	सूर्यदेव	सूर्यदेव
sendha	सेंधा	सेंधा
senvai	सेंवई	सेनवाई
sevai	सेंवई	सेवाई
sensing	सेंसिंग	सेंसिंग
sexual	सेक्सुअल	सेक्लुल
saturday	सेटरडे	सतुरदाय
seti	सेटी	सेती
seto	सेटो	सेटो
seth	सेथ	सेथ
safety	सेफ्टी	सफे्टी
semen	सेमिन	सीमें
semin	सेमिन	सेमिन
self	सेल्फ	सेल्
selfie	सेल्फी	सेल्फी
save	सेव	साव
sev	सेव	सेव
sevakon	सेवकों	सेवकों
sevkon	सेवकों	सेवकों
samuels	सैम्युल्स	सममयल्स
celery	सैलरी	सेलरी
salary	सैलरी	साारी
sakar	सॉकर	सकर
socar	सॉकर	सोकर
soccer	सॉकर	सोक्
songs	सॉन्ग्स	सांग्स
solicitor	सॉलिसिटर	सोलियिटर
sochane	सोचने	सोचने
sochne	सोचने	सोचने
sonu	सोनू	सोनू
soma	सोमा	सोमा
spma	सोमा	स्पमा
somi	सोमी	सोमी
soy	सोय	सोय
soya	सोया	सोया
solitaire	सोलिटेयर	सोलिटेयर
soharai	सोहराई	सोहराई
sohrai	सोहराई	सोहराई
sohaval	सोहावल	सोहववल
sohawal	सोहावल	सोहवाल
saunpane	सौंपने	सौंपने
sonpne	सौंपने	सौंपेे
scala	स्काला	स्काल
skala	स्काला	स्का
ski	स्की	सससी
scootaron	स्कूटरों	स्कूटरों
scooteron	स्कूटरों	स्कूटरों
skootaron	स्कूटरों	स्कूटरों
scandinavia	स्कैंडिनेविया	स्कंंडिविवा
scaining	स्कैनिंग	स्केंििंग
scanning	स्कैनिंग	स्कांििंग
squash	स्क्वाश	स्क्वाड
squash	स्क्वैश	स्क्वाड
skhalan	स्खलन	स्खलन
stain	स्टैन	स्टेन
stan	स्टैन	स्टन
stop	स्टॉप	स्टॉप
stops	स्टॉप्स	स्टॉप्स
stone	स्टोन	स्टनन
straws	स्ट्रास	स्ट्रेस
stress	स्ट्रास	स्ट्रेस
stra	स्ट्रे	स्ट्रा
stray	स्ट्रे	स्टरर
stre	स्ट्रे	स्ट्रे
strocks	स्ट्रोक्स	स्ट्रॉक्स
strokes	स्ट्रोक्स	स्ट्रॉक्स
stan	स्तन	स्टन
stanadhari	स्तनधारी	स्तनधारी
standhaari	स्तनधारी	स्तंधारी
standhari	स्तनधारी	स्तंधारी
sthiti	स्तिथि	स्थिति
stithi	स्तिथि	स्टिथी
stuti	स्तुति	स्टुटि
sthitiyaan	स्थितियां	स्थितियां
sthitiyan	स्थितियां	स्थितियां
sthitiyon	स्थितियों	स्थितियों
sthool	स्थूल	स्थूल
sthul	स्थूल	स्थुल
sthoolta	स्थूलता	स्थुलत
sthulata	स्थूलता	स्थुलता
sneakers	स्नीकर्स	स्नेकर््स
snickers	स्नीकर्स	स्निक्््
snikarse	स्नीकर्स	स्निकर्स
spear	स्पीयर	स्पीयर
spell	स्पेल	स्पेल
spelar	स्पेलर	स्पेलर
speller	स्पेलर	स्पीलर
sprint	स्प्रिट	स्प्रिं
sprit	स्प्रिट	स्प्रिट
spray	स्प्रे	स्परर
spry	स्प्रे	स्प्री
sfoorti	स्फूर्ति	स्फूर्ति
sfurti	स्फूर्ति	स्फूर्ति
sphoorti	स्फूर्ति	स्फूर्ति
slide	स्लाइड	स्लीइ
slider	स्लाइडर	स्लीइर
slaaidon	स्लाइडों	स्लाइडों
slidon	स्लाइडों	स्लीडों
sliders	स्लाइड्स	स्लीडर्स
slides	स्लाइड्स	स्लाइडस
slice	स्लाइस	स्लिस
slash	स्लैश	स्लेश
swaroopon	स्वरुपों	स्वरूपों
swarupon	स्वरुपों	स्वरूपों
swa	स्वा	स्व
swaachaalit	स्वाचालित	स्वाचालित
swachalit	स्वाचालित	स्वाचालित
swaarthparak	स्वार्थपरक	स्वरततर्थक
swarthparak	स्वार्थपरक	स्वर्तथारक
swiftlate	स्विफ्टलेट	स्विफफटटट
swiftlet	स्विफ्टलेट	स्विफ्टेट्ट
sweekarte	स्वीकारते	स्वीकारते
swikarte	स्वीकारते	स्वीकर्ट
sweet	स्वीट	स्वीत
sweep	स्वीप	स्वीप
sweccha	स्वेच्छा	स्वेच्छा
swecha	स्वेच्छा	स्वेच्छ
swechha	स्वेच्छा	स्वेच्छा
sweta	स्वेता	स्वेटा
swap	स्वैप	स्वपप
swipe	स्वैप	स्वीप
handiya	हंडिया	हंदिया
handiyaa	हंडिया	हंदिया
hundiya	हंडिया	हंडिया
hakikat	हकीकत	हककिक
haqeeqat	हकीकत	हकीत
hathiya	हथिया	हथथया
hamala	हमला	हमला
hamla	हमला	हमला
hamalavar	हमलावर	हमालवर
hamlavar	हमलावर	हमलावर
humlavar	हमलावर	हमलावर
hamaal	हमाल	हमाल
hamal	हमाल	हमल
hercules	हरक्यूलिस	हर्केल्स
hardas	हरदास	हरदास
harpaal	हरपाल	हरपपल
harpal	हरपाल	हरपलल
harvansh	हरवंश	हरववंश
haraval	हरावल	हरवाल
harawal	हरावल	हरावल
hurricane	हरिकेन	हरिकेन
harijan	हरिजन	हरिजन
hariyali	हरियाली	हरियाल
harshit	हर्षित	हर्शित
haldi	हल्दी	हा्दी
halla	हल्ला	हल्ल
hawamahal	हवामहल	हवामााल
hawalaat	हवालात	हवालत
hawalat	हवालात	हवालत
hasino	हसीनों	हससनों
hasinon	हसीनों	हसननयों
haan	हां	हान
han	हां	हान
haanfte	हांफते	हांफते
hafate	हांफते	हफाते
hanfte	हांफते	हैंफे
higman	हाइमन	हिगमान
hymen	हाइमन	हममें
hadauti	हाड़ौती	हड़तत
haani	हानी	हानी
hani	हानी	हानी
haarjeet	हारजीत	हाजजित
harjeet	हारजीत	हारजीत
haaranaa	हारना	हाणना
harana	हारना	हराा
harna	हारना	हरना
haalchaal	हालचाल	हालचल
haalchal	हालचाल	हालचल
halchaal	हालचाल	हलचलल
halchal	हालचाल	हलचलल
halt	हाल्ट	हाल्ट
hault	हाल्ट	हाल्ट
hahakar	हाहाकार	हहाकर
hingis	हिंगिस	हांगिस
hindan	हिंडन	हिंदन
hindon	हिंडन	हिंडों
hijada	हिजड़ा	हिजड़ा
hijda	हिजड़ा	हिजदा
hijbul	हिजबुल	हिजबूल
hippo	हिप्पो	हिप्पो
hippopotamus	हिप्पोपोटेमस	हिप्पोप्सम
himali	हिमाली	हिमाली
hilane	हिलने	हिलने
hilne	हिलने	हिलने
hisham	हिशाम	हिशम
heeraganj	हीरागंज	हीरगगगज
hiraganj	हीरागंज	हिरांग
heroes	हीरोज	हेरोस
heros	हीरोज	हेरोस
hui	हुईं	हुई
huin	हुईं	हुए
hooper	हूपर	हूपर
huppar	हूपर	हुपपर
hupper	हूपर	हपपरर
hegde	हेगडे	हेगे
hemvati	हेमवती	हेमवाी
hemwati	हेमवती	हेमवती
help	हेल्प	हेल्प
helper	हेल्पर	हेल्प
haito	हैतो	हैटो
hairam	हैरम	हैरम
harem	हैरम	हररम
herald	हैराल्ड	हेराल्ड
haive	हैव	हैवे
have	हैव	हाव
hong	हॉन्ग	होंग
half	हॉफ	हाल
hoaf	हॉफ	हॉफ
hounga	होऊंगा	हौंगग
holding	होल्डिंग	हॉलिंग
hoshangabaad	होशंगाबाद	होशनगबााद
hoshangabad	होशंगाबाद	होशनगबबाद
hostes	होस्टेस	हॉस्टेस
hostess	होस्टेस	हॉस्टेस
