Input	Target	Predicted
ank	अंक	अंक
anka	अंक	अंका
ankit	अंकित	अंकित
anakon	अंकों	अंकों
ankhon	अंकों	अंकों
ankon	अंकों	अंकों
angkor	अंकोर	अंगको
ankor	अंकोर	अंकोर
angaarak	अंगारक	अंगारक
angarak	अंगारक	अंगररक
angraji	अंग्रज़ी	अंग्रजीी
angreji	अंग्रज़ी	अंग्रेीी
angrzi	अंग्रज़ी	अंग्रजीी
antah	अंतः	अंतः
antaha	अंतः	अंताा
antarmukh	अंतर्मुख	अंतरममुख
antmurkh	अंतर्मुख	अंतमुुकख
antrmukh	अंतर्मुख	अंतर्मुख
andrabee	अंद्राबी	अंदररबबी
andrabi	अंद्राबी	अंद्रबीी
andha	अंधा	अंधा
andhapan	अंधापन	अंधपपन
andheri	अंधेरी	अंधररी
ambaani	अंबानी	अंबानी
ambani	अंबानी	अंबननी
akram	अकरम	अक््म
acapulco	अकापुल्को	अकापुल्को
akapulko	अकापुल्को	अकापुलकको
akhand	अखंड	अख़ड
akhil	अखिल	अखिल
agavai	अगवाई	अगवाई
agvaai	अगवाई	अग्ाई
augustine	अगस्टाइन	औगु्तिनन
augustustine	अगस्टाइन	औगुस्ुसस््टननननननन
agsta	अगस्ता	अग््ता
agusta	अगस्ता	अगुसता
augusta	अगस्ता	औगुसता
agr	अग्र	अग्र
agra	अग्र	अग्रा
achambha	अचंभा	अचंभा
achanbha	अचंभा	अचाभा
achievement	अचीवमेंट	अचिवेेंं
achivement	अचीवमेंट	अचिवेेंं
acchi	अच्छी	अच्छी
achchi	अच्छी	अच्छी
achhi	अच्छी	अच्छी
achyut	अच्युत	अच्यूट
achhanera	अछनेरा	अछानरा
achnera	अछनेरा	अछनेरा
ajmeedh	अजमीढ़	अजमीध़
ajhar	अजहर	अझरर
azhar	अजहर	अझ़र
ajit	अजित	अजित
agnat	अज्ञात	अज्ञात
agyaat	अज्ञात	अज्ञात
agyat	अज्ञात	अज्ञात
atakta	अटकता	अतकता
atkata	अटकता	अतकाा
atake	अटके	अटके
atke	अटके	अतके
atwaal	अटवाल	अतवाल
atwal	अटवाल	अतवाल
attahasa	अट्टहास	अत्ााााा
atthaas	अट्टहास	अत्ठासस
atthas	अट्टहास	अट्टहास
addon	अड्डों	अड्डों
athak	अथक	अथक
atharv	अथर्व	अथर्व
atharva	अथर्व	अथर्व
adad	अदद	अददद
adaani	अदाणी	अदानी
adani	अदाणी	अदानी
advait	अद्वैत	अद्वैत
adwait	अद्वैत	अड्वैत
advaitvaad	अद्वैतवाद	अदववैतवाद
advaitwad	अद्वैतवाद	अदववैतवाद
adhivas	अधिवास	अधिवास
adhiwas	अधिवास	अधिवास
advivas	अधिवास	अदवववस
adhiik	अधीक	अधीक
adhik	अधीक	आधिक
adhyayanarat	अध्ययनरत	अध्ययनार
adhyayanrat	अध्ययनरत	अध्ययनररत
adhyaynrat	अध्ययनरत	अध्ययनरत
anant	अनंत	अनां
ananti	अनंती	अनाती
angadh	अनगढ़	अंगा़
angarh	अनगढ़	अंगऱ
anchahe	अनचाहे	अंचचहे
anthak	अनथक	अं्क
unthak	अनथक	उं्क
anhoni	अनहोनी	अनहहनी
anaavashyak	अनावश्यक	अनावश्यक
anavashyak	अनावश्यक	अनावश्यक
anavshyak	अनावश्यक	अनावश्यक
anawashyak	अनावश्यक	अनावश्यक
anik	अनिक	अनिक
anishwarvadi	अनीश्वरवादी	अनिश्वववददी
anishwarwadi	अनीश्वरवादी	अनिश्वरवादी
anukoltha	अनुकूलता	अनुकोल्थ
anukulata	अनुकूलता	अनुकूलता
anukulta	अनुकूलता	अनुकुलता
anuchit	अनुचित	अनुचित
anuprayogi	अनुप्रयोगों	अनुप्रयोगों
anuprayogon	अनुप्रयोगों	अनुप्रयोगों
anupryogon	अनुप्रयोगों	अनुप्रयोगों
anureet	अनुरीत	अनुरीत
anurit	अनुरीत	अनुरित
anuthi	अनूठी	अनूठी
anudit	अनूदित	अनुदित
anyaay	अन्याय	अन्याय
anyay	अन्याय	अन्यय
anyaya	अन्याय	अन्ययया
apnani	अपनानी	अपनननी
aparivartanshali	अपरिवर्तनशील	अपरिवर््नशलली
aparivartansheel	अपरिवर्तनशील	अपरिवर्तनशील
aparivartanshil	अपरिवर्तनशील	अपरिवर््शिल
apariharya	अपरिहार्य	अपरिहाय्य
aprihary	अपरिहार्य	अप्िहार्य
apriyary	अपरिहार्य	अप्ियययीय
apavartit	अपवर्तित	अपवर्तित
apvartit	अपवर्तित	अपवर्तित
apvtrit	अपवर्तित	अपव्तततत
apaardarshi	अपारदर्शी	अपारदर्शी
apardarshi	अपारदर्शी	अपररदरशशी
afroj	अफरोज	अफ्रो़
afroz	अफरोज	अफ््ो़
africa	अफ्रीका	अफररिका
abbaasi	अब्बासी	अब्बासी
abbasi	अब्बासी	अब्बासी
abhimat	अभिमत	अभिमत
abhishap	अभिशाप	अभिषाप
abhi	अभी	अभी
amjhera	अमझेरा	अं्ेरा
amzera	अमझेरा	अम्ेरा
amargad	अमरगढ़	अमररग़
amargarh	अमरगढ़	अमररऱ
amarpaal	अमरपाल	अमरपाा
amarpal	अमरपाल	अमरपपा
amarohi	अमरोही	अमरोहि
amrohi	अमरोही	अमरोही
amaanat	अमानत	अमानत
amanat	अमानत	अमानत
amanth	अमानत	अमंं
amaanati	अमानती	अमानती
amanathi	अमानती	अमानाी
amanati	अमानती	अमानती
amavasya	अमावस्या	अमावस्य
amavsya	अमावस्या	अमावस्य
amit	अमित	अमित
amitao	अमिताव	अमिता
amitav	अमिताव	अमिताव
amuk	अमुक	अमुक
amogh	अमोघ	अमोग
ambani	अम्बानी	अंबबानी
ayodhyaanaath	अयोध्यानाथ	अयोध्यानाथ
ayodhyanaath	अयोध्यानाथ	अयोध्यानाथ
ayodhyanath	अयोध्यानाथ	अयोध्यानथथ
ayodhyeanath	अयोध्यानाथ	अयोध्यानाथ
aradas	अरदास	अरदास
ardaas	अरदास	अरदास
ardas	अरदास	अर्दस
arabab	अरबाब	अरबबब
arbab	अरबाब	अरबबब
around	अराउंड	आरूउंड
arjent	अर्जेंट	अरजजेंट
urgent	अर्जेंट	अर्जेंट
arth	अर्थ	अर्थ
artha	अर्थ	अर्था
earth	अर्थ	एर्थ
earthquake	अर्थक्वेक	एर्थकूककक
arthon	अर्थों	अर्थों
arpit	अर्पित	अर्पित
aryama	अर्यमा	अर्यमा
aryma	अर्यमा	अर्यमा
arymaa	अर्यमा	अर्यमाा
alankaar	अलंकार	अलंकार
alankar	अलंकार	अलंकरर
alnkaar	अलंकार	अलंकार
alankaaron	अलंकारों	अलंकारों
alankaron	अलंकारों	अलंकररों
alnkaaron	अलंकारों	अलंकारों
alnkaron	अलंकारों	अलंकररों
alagavavadi	अलगाववादी	अलगवववादी
algavvadi	अलगाववादी	अलगगववादी
algavwaadi	अलगाववादी	अलगगववादी
alive	अलाइव	अलिवव
alance	अलायंस	एलंंस
alayans	अलायंस	एलायसस
aliance	अलायंस	एलियंस
alind	अलिंद	एलिंड
alai	अली	अलाई
ali	अली	अली
alii	अली	अली
alonso	अलोंसो	एलोंसो
aloso	अलोंसो	एलोस
alphabet	अल्फ़ाबेट	अल्फाेइटट
alba	अल्बा	अलबबा
avantipur	अवंतिपुर	अवंतिपुर
awantipora	अवंतिपुर	अवातिपोरा
avaru	अवरु	अवरु
avru	अवरु	अवरू
awaru	अवरु	अवार
avarodhak	अवरोधक	अवरोधक
avrodhak	अवरोधक	अवरोधक
avrodhk	अवरोधक	अवरोधक
avarnata	अवर्णता	अवर्णता
avarnataa	अवर्णता	अवर्णता
avranta	अवर्णता	अवरंतता
avashist	अवशिष्ट	अवशिस्ट
avshisht	अवशिष्ट	अवशिष्ट
awashist	अवशिष्ट	अवशिस्ट
avasthaayen	अवस्थाएं	अवस्थाएं
avsthaen	अवस्थाएं	अवस्थाएं
avsthayen	अवस्थाएं	अवस्थाएं
awasthaen	अवस्थाएं	अवस्थाएं
avi	अवि	अवी
avika	अविका	अविका
aviral	अविरल	अविरा
avirl	अविरल	अविर्
avishvaasniy	अविश्वसनीय	अविश्वसनीय
avishvasniy	अविश्वसनीय	अविश्वससीय
avishvasniya	अविश्वसनीय	अविश्वसनीय
avisvasniya	अविश्वसनीय	अविस्वससनय
aviva	अवीवा	अवववा
avaigyanic	अवैज्ञानिक	अवैज्ञानिक
avaigyanik	अवैज्ञानिक	अवैज्ञानिक
avegyanik	अवैज्ञानिक	अवेज्ञानिक
ashaktataa	अशक्तता	अशक्तता
ashktta	अशक्तता	अश््तता
asharaphi	अशरफी	अशााीफ
ashrafi	अशरफी	अश्ाा
ashariri	अशरीरी	अशाररी
ashriri	अशरीरी	अश्ररी
ashrvatath	अश्वत्थ	अश्ववतथा
ashvtth	अश्वत्थ	अश्वत्थ
asamaany	असमान्य	असमान्य
asamany	असमान्य	असमान्य
asmanye	असमान्य	अस्ान्
asaamnjsy	असामंजस्य	असामंंसीस
asamanjasy	असामंजस्य	असममंजससस
asamanjasya	असामंजस्य	असममंजसयय
asurakshit	असुरक्षित	असुकक्षित
asurkshit	असुरक्षित	असुर््षित
aset	असेट	असेट
asset	असेट	एसेट
asvabhavik	अस्वभाविक	अस्वभाविक
aswabhavik	अस्वभाविक	अस्वाभविक
aswbhavik	अस्वभाविक	अस्वभाविक
ahirauli	अहिरौली	अहिरौली
item	आइटम	इतटम
items	आइटम्स	इटटममस
idle	आइडल	इडडल
idol	आइडल	इडडल
icc	आइसीसी	आइसीसी
iso	आइसो	आईस
ipc	आईपीसी	आईपीसी
ipad	आईपैड	आईपैड
iris	आईरिस	इररिि
ounce	आउंस	ऑंसस
aakaash	आकाश	आकाश
aakash	आकाश	आकाश
aake	आके	आके
aakhet	आखेट	आखेत
akhet	आखेट	अखेत
aagat	आगत	आगत
aagaman	आगमन	आगमन
aagman	आगमन	आगमम
aagaa	आग़ा	आगाा
aagah	आग़ा	आगह
agha	आग़ा	अघा
aagaashe	आगाशे	आगाशे
aagashe	आगाशे	आगशशे
agashe	आगाशे	अगशेे
aajmaanaa	आजमाना	आजमाना
aajmana	आजमाना	आजमाना
aazmaanaa	आजमाना	आजमाना
aata	आटा	आता
ata	आटा	अता
atta	आटा	अत्
aatmayen	आत्माएं	आत्मयएं
atmaen	आत्माएं	अत्माएं
aadaan	आदान	आदान
aadan	आदान	आदनन
aadhaarit	आधारित	आधारित
aadharit	आधारित	आधारित
adharit	आधारित	अधारित
aadheen	आधीन	आधीन
aadhin	आधीन	आधिन
aadhunik	आधुनिक	आधुनिक
aanad	आनद	आनद
aanand	आनद	आनां
anand	आनद	अनां
aapka	आपका	आपका
aapkaa	आपका	आपका
aapadaaaen	आपदाएं	आपदाएं
aapdaein	आपदाएं	आपदाएं
aapdayein	आपदाएं	आपदाएए
aabantit	आबंटित	आबाततत
abantit	आबंटित	अबाततत
aabru	आबरू	आबरू
abaru	आबरू	अबार
aamdan	आमदन	आमदा
amadan	आमदन	अमाा
aamdani	आमदनी	आमददीी
amadani	आमदनी	अमाान
aamdi	आमदी	आमदी
amdi	आमदी	अमडी
aamod	आमोद	आमोद
amod	आमोद	अमोद
aayenge	आयेंगे	आयंंगे
aayojak	आयोजक	आयोजक
ro	आरओ	रो
rp	आरपी	आरपी
aaraam	आराम	आराम
aaram	आराम	आराम
aram	आराम	अराम
aarushi	आरुषि	आरुषि
arushi	आरुषि	अरुशी
artery	आर्टरी	अर्टरी
order	आर्डर	ऑर्डर
aary	आर्य	आर्य
aarya	आर्य	आर्य
arya	आर्य	अर्या
aaryika	आर्यिका	आर्यिका
aryika	आर्यिका	आर्यिका
aarya	आर्यो	आर्यो
arya	आर्यो	अर्या
aryo	आर्यो	अर्यो
aaryan	आर्यों	आर्यों
arya	आर्यों	अर्या
aryon	आर्यों	अर्यों
aalsi	आलसी	आलसस
alasi	आलसी	अलसस
aalochak	आलोचक	आलोचक
alochak	आलोचक	अलोचक
aalochakon	आलोचकों	आलोचकों
alochakon	आलोचकों	अलोचकों
aalha	आल्हा	आलहहा
aalhaa	आल्हा	आलहहा
alha	आल्हा	अलहहा
allah	आल्हा	अल्ल
aawaazen	आवाज़ें	आवाज़ें
aawajen	आवाज़ें	आवाजेन
awaazen	आवाज़ें	अवाजेे
awazen	आवाज़ें	अवाजेन
aawajon	आवाज़ों	आवाजोंं
aawazon	आवाज़ों	आवाजोों
awaazon	आवाज़ों	अवाजोों
awazon	आवाज़ों	अवाजोों
aavishakaar	आविष्कार	आविषककार
aavishkaar	आविष्कार	आविश्कार
avishkar	आविष्कार	अविश्करर
aavriti	आवृत्ति	आवृति
aavritti	आवृत्ति	आवृत्ति
avuti	आवृत्ति	आवृत्ति
aavritiyon	आवृत्तियों	आवृतियोयों
aavrittiyon	आवृत्तियों	आवृत्तियों
avrutiyon	आवृत्तियों	अवृतियियों
aashanka	आशंका	आशंकक
ashanka	आशंका	अशाका
aashriton	आश्रितों	आश्रितों
ashriton	आश्रितों	अश्रततों
aasaan	आसान	आसान
aasan	आसान	आसनन
asan	आसान	असनन
aastik	आस्तिक	आस्तिक
astik	आस्तिक	अस्तिक
aasteen	आस्तीन	आस्तीन
aastin	आस्तीन	आस्तिन
astin	आस्तीन	अस्तिन
aahnaan	आह्नान	आह्नान
aahnan	आह्नान	आह्नान
ahyan	आह्नान	अह्या
england	इंग्लैंड	एंगललांड
engineer	इंजिनियर	इंजिनियर
introduction	इंट्रोडक्शन	इंट्रोडक्शन
insurance	इंश्योरेंस	इंसररां्ंस
ear	इअर	इअर
eyer	इअर	एयर
eon	इआन	इयन
iaan	इआन	इईन
ekattha	इकट्ठा	एकत्ठ
ikattha	इकट्ठा	इकत्ठा
ekatthi	इकठ्ठी	एकत्थी
ekthi	इकठ्ठी	इकठ्ठी
ikatthi	इकठ्ठी	इकत्ठी
ekaee	इकाई	एकाई
ikai	इकाई	इकाई
ekaeyon	इकाईयों	इकाएयों
ikaiyon	इकाईयों	इकाइयों
ikarion	इकाईयों	इकाररों
economic	इकोनोमिक	इकोनोमिक
ecuador	इक्वाडोर	इक्याडोर
equador	इक्वाडोर	इक्वाडोर
equities	इक्विटीज	इक्विटिस
ikvitija	इक्विटीज	इक्वितिजा
ijaajat	इजाजत	इजाजत
ijajat	इजाजत	इजजजत
inhalation	इनहेलेशन	इन्हलाशन
inhaletion	इनहेलेशन	इन्हलेशन
ibija	इबीजा	इबिजा
ibiza	इबीजा	इबिजजाा
imaging	इमेजिंग	इमागिगग
immune	इम्युन	इम्यूनन
elaichi	इलाइची	एलैइची
ilaichi	इलाइची	इलाइची
ilayachi	इलाइची	इलायची
ilayichi	इलाइची	इलाययि
elaaj	इलाज	एलाजज
ilaaj	इलाज	इलाज
ilaj	इलाज	इलाज
ishaak	इशाक	इशाक
ishaaq	इशाक	इशाक
ishak	इशाक	इशाक
ishaara	इशारा	इशारा
ishaaraa	इशारा	इशारा
ishara	इशारा	इशारा
ishita	इशिता	इशिता
isht	इष्ट	इश्ट
isteefe	इस्तीफे	इस्तीफे
istife	इस्तीफे	इस्टिफ
ea	ईए	ईई
ia	ईए	ईआ
eater	ईटर	एतर
iter	ईटर	इतर
email	ईमेल	ईमेल
emailon	ईमेलों	एमैलों
emelon	ईमेलों	एमेलों
evening	ईवनिंग	इवेनंग
east	ईष्ट	एस्ट
ishat	ईष्ट	इशाट
isht	ईष्ट	इश्ट
isaaiyon	ईसाइयों	इसाइयों
isaiyon	ईसाइयों	इसाइयों
isayiyon	ईसाइयों	इसाययों
ikhrul	उखरुल	इखरुल
ukhrool	उखरुल	उखरूल
ukhrul	उखरुल	उखरुल
uchhalane	उछालने	उछालने
uchhalne	उछालने	उछ्लने
ujback	उज़्बेक	उज्बबकक
uzbek	उज़्बेक	उज्बबकक
uthane	उठने	उठने
uthne	उठने	उठने
uthaakar	उठाकर	उठाकर
uthakar	उठाकर	उठाकर
uthaapatak	उठापटक	उठापतक
uthapatak	उठापटक	उठापतक
uthen	उठें	उठेन
udaan	उड़ान	उड़नन
udan	उड़ान	उड़नन
udaanaa	उड़ाना	उड़नाा
udana	उड़ाना	उड़ना
udaane	उड़ाने	उड़नने
udane	उड़ाने	उड़नने
udaanen	उड़ानें	उदाननें
udanen	उड़ानें	उड़नन
udaanon	उड़ानों	उड़ानों
udanon	उड़ानों	उड़ननंं
utane	उतने	उताे
utaney	उतने	उताे
utne	उतने	उतने
uttara	उत्तरा	उत्तरा
uttra	उत्तरा	उत्त्
utpan	उत्पन	उत्पन
udant	उदंत	उड़ं
udghosh	उदघोष	उद्घो
udar	उदर	उदर
uda	उदा	उडा
udaa	उदा	उडा
udakishuganj	उदाकिशुनगंज	उद़किशाजजजज
udakishunganj	उदाकिशुनगंज	उद़किशां्ंज
unatees	उनतीस	उननतट
untees	उनतीस	उनतीस
uniyal	उनियाल	उनियाल
upadraviyon	उपद्रवियों	उपद्रवियों
updravion	उपद्रवियों	उप््रवियो
updraviyon	उपद्रवियों	उप््रवियों
upadravi	उपद्रवी	उपद्रवी
updravi	उपद्रवी	उपद्रवी
upadrawon	उपद्रवों	उपद्रवों
updravon	उपद्रवों	उपद्रवों
upneta	उपनेता	उपनेता
upabhokta	उपभोक्ता	उपभोक्त
upbhokta	उपभोक्ता	उपभोकताा
uplaksh	उपलक्ष्य	उपलक्ष
uplakshay	उपलक्ष्य	उपलक्षाय
uplakshya	उपलक्ष्य	उपलक्ष्य
uplabdh	उपलब्ध	उपला्ध
uplabdhiyon	उपलब्धियों	उपला्धियों
uplabdhi	उपलब्धी	उपला्धि
upakhyaanon	उपाख्यानों	उपखख्यानों
upakhyanon	उपाख्यानों	उपखख्यानों
ubuntu	उबंटू	उबुतू
ubaal	उबाल	उबाल
ubal	उबाल	उबाल
ubhaara	उभारा	उभररा
ubhara	उभारा	उभराा
umanath	उमानाथ	उमानाथ
umesh	उमेश	उमेश
urf	उर्फ	आरफफ
urfa	उर्फ	उर्फा
urff	उर्फ	आरफफ
urvarakon	उर्वरकों	उर्वरकको
urvarkon	उर्वरकों	उर्वर्कं
urwarakon	उर्वरकों	उरववररको
urvarata	उर्वरता	उर्वररा
urvarta	उर्वरता	उर्वर्ा
urwarta	उर्वरता	उरववर्ा
ulate	उलटे	उलटे
ulte	उलटे	उल्े
ulahana	उलाहना	उलाहाा
ulahna	उलाहना	उलाहना
ulema	उलेमा	उलेमा
ulemaon	उलेमाओं	उलेमाओं
usak	उसक	उसक
usaki	उसकी	उसकी
uski	उसकी	उस्ी
usmein	उसमें	उस्ेे
usmen	उसमें	उसमें
usi	उसी	उसी
ustara	उस्तरा	उस्ताा
udharv	ऊर्ध्व	उधरववव
udhrva	ऊर्ध्व	ऊर्ध्व
urdhav	ऊर्ध्व	उर्धवव
ushma	ऊष्मा	ऊष्मा
rishicool	ऋषिकुल	रशिकूलू
rishikul	ऋषिकुल	रशिकुल
rushikul	ऋषिकुल	रषिकुल
enzyme	एंजाइम	इंज्मम
anton	एंटोन	अंटों
entone	एंटोन	इंटोन
antoni	एंटोनी	अंटोनी
antony	एंटोनी	अंटोनी
endometrial	एंडोमेट्रियल	एंडोमेट्रियल
andreas	एंड्रियास	अंड्रेस
als	एएलएस	एलससस
asi	एएसआई	आसीी
eksaath	एकसाथ	एकसाथ
eksath	एकसाथ	एक्ाथ
ekaki	एकाकी	एकककी
xm	एक्सएम	एक्सएम
egmor	एगमोर	इगमोर
egmore	एगमोर	इगमोर
aj	एजे	अज
agende	एजेंडे	अगेंडे
adp	एडीपी	एडीपी
adain	एडेन	अडान
aden	एडेन	अडेन
edan	एडेन	एडनन
addi	एड्डी	अडीीी
eddi	एड्डी	एड्डी
eddie	एड्डी	इडीी
eddy	एड्डी	इडीडी
apj	एपीजे	अपजज
ftii	एफटीआईआई	एफटीआईआई
abbott	एबट	अब्बटटटटटटटटटटटटटटटटटटटटटटटटटटट
abut	एबट	अबुट
ebt	एबट	एब्ट
abvp	एबीवीपी	अब्पपप
abbot	एबोट	एबोट
abbott	एबोट	एबोट
mta	एमटीए	एमटीए
mtake	एमटेक	एमटेक
mtec	एमटेक	एमटीट
mtech	एमटेक	एमटेक
emerald	एमरल्ड	एमररलड
emrald	एमरल्ड	एमरल्ड
emil	एमिल	एमिल
emile	एमिल	इमिले
emily	एमिल	एमिली
amy	एमी	एम्
emi	एमी	एमी
airway	एयरवे	अयरवा
eyarave	एयरवे	इयरवे
eyarve	एयरवे	इयरव
error	एरर	इरररर
arica	एरिका	आरिका
erica	एरिका	एरिका
erika	एरिका	एरिका
aerobic	एरोबिक	एरोबिक
aerobics	एरोबिक	एररबिक््ससससससससससससससससससससससस
lte	एलटीई	लटे
lti	एलटीई	एलटीई
allergic	एलर्जिक	एल्रररि
eliminator	एलिमिनेटर	इलिमिनटटर
aliens	एलियंस	एलिंंस
alliance	एलियंस	एलियंसस
asian	एशियन	असिन
sfc	एसएफसी	ससफसससस
sk	एसके	सससस
spf	एसपीएफ	एसफफफफ
association	एसोसिएशन	एसोसिशशन
astar	एस्टर	एस्टर
aster	एस्टर	अस्टर
ester	एस्टर	एस्टर
aesthetics	एस्थेटिक	एए्टेटिक्
asthetic	एस्थेटिक	एस्थेटिक
asfalt	एस्फाल्ट	अस्फलल्
asphalt	एस्फाल्ट	एस्फाल्ट
asphault	एस्फाल्ट	अस्फललतत
ahsaas	एहसास	अहसास
ehsaas	एहसास	एहसास
ehsas	एहसास	एहससस
aisa	एेसा	आसस
eesa	एेसा	एेसा
ainth	ऐंठ	ऐंठ
end	ऐंठ	एंड
enth	ऐंठ	एंठ
ainthey	ऐंठे	एंठे
enthe	ऐंठे	इंठे
aithan	ऐठन	ऐता
ethan	ऐठन	एथा
ethhan	ऐठन	एथा
ail	ऐल	एलल
el	ऐल	ऐल
alaps	ऐल्प्स	ऐल्प्स
alps	ऐल्प्स	एल्प्स
aise	ऐसे	एसे
oxide	ऑक्साइड	ऑक्सीइड
oxy	ऑक्सी	ऑक्सी
offers	ऑफर्स	ऑफर्स
offshor	ऑफशोर	ओफ्शर
offshore	ऑफशोर	ऑफ्शर
official	ऑफिशियल	ऑफिइियल
okalahoma	ओकलाहोमा	ओकलाहममा
oklahoma	ओकलाहोमा	ओक्ाहोमा
oklahoma	ओक्लाहोमा	ओक्लाहममा
ot	ओत	ओट
opel	ओपेल	ऑपेल
obrayan	ओब्रायन	ओब्रायन
obrien	ओब्रायन	ओब्रिइन
oran	ओरण	ओरा
orian	ओरियन	ओरियन
orion	ओरियन	ऑरियन
olavrishti	ओलावृष्टि	ओलवषृतीट
ovum	ओवम	ओवु
owem	ओवम	ऑवम
oceanic	ओशनिक	ऑकेेनि
osaka	ओसाका	ओसकका
auchity	औचित्य	औचित्
auchitya	औचित्य	औचित्य
audhyogikaran	औद्योगिकरण	औध्योगिकरण
audyogikarana	औद्योगिकरण	औद्योगिकाण
audyogikikaran	औद्योगिकरण	औद्योगिकरण
aurangabad	औरंगाबाद	औरंगबबा
aurora	औरोरा	औरोरा
aulakh	औलख	औलख
kankad	कंकड़	काकड़
kankar	कंकड़	काककर
kankad	कंकर	काकडड
kankar	कंकर	काककर
kangan	कंगन	कंगन
conjunction	कंजंक्शन	कंंूक्शन
contemporary	कंटेम्पररी	कंटटमपरररर
kanthahar	कंठहार	कंठहार
kanthhar	कंठहार	कंठर
composer	कंपोजर	कॉपोरर
kambalon	कंबलों	कामललो
kanblon	कंबलों	कंबलों
consultant	कंसलटेंट	कंसू्टटट
kakkad	कक्कड़	कक्कड
kakkar	कक्कड़	कक्करर
kacche	कच्चे	कच्चे
kachche	कच्चे	कच्चे
karta	कटरा	कररता
katra	कटरा	कत्ा
cutlery	कटलरी	कटटरी
katlari	कटलरी	कट्ारी
katlary	कटलरी	कटलरी
katasaraj	कटासराज	कटासराज
kathfodave	कठफोड़वे	कथफोडवेे
kathfodve	कठफोड़वे	कथफोड़ेे
kathor	कठोर	कथोर
kathore	कठोर	कथोरे
kanika	कणिका	कािका
kathai	कत्थई	कठा
katthai	कत्थई	कट्ठा
katthaii	कत्थई	कट्ठै
convention	कनवेंशन	कन्ेंशन
canals	कनाल	कैनल्सससससससससससससससससससससससससस
kanaal	कनाल	कनाल
kanal	कनाल	कााल
kanindham	कनिंघम	कािंंम
kaningham	कनिंघम	कानंगघ
kanishthika	कनिष्ठिका	कािष्ठिका
kanishthikaa	कनिष्ठिका	कनिष्ठिका
kanishtika	कनिष्ठिका	कािष्टिका
kanyaayen	कन्याएं	का्याएं
kanyaein	कन्याएं	का्याएं
kanyayen	कन्याएं	का्ययएं
convention	कन्वेंशन	कन्वेंशन
convocation	कन्वोकेशन	कन्वोक्शन
cup	कप	कप
kap	कप	का
kapda	कपड़ा	कप़्ा
kpada	कपड़ा	कपड़ा
kapdo	कपड़ो	कप़्ो
kapdon	कपड़ो	कप़्ों
kaping	कपिंग	काींग
kping	कपिंग	कपिंग
kapolkalpana	कपोलकल्पना	कपोलकललपना
kabaddi	कबड्डी	कबाददी
kabr	कब्र	कबरर
kabra	कब्र	कबरर
kabren	कब्रें	कबररेन
kabron	कब्रों	कबररों
kamjor	कमज़ोर	कामोोर
kamzor	कमज़ोर	कमज़ोर
kamatar	कमतर	कममार
kamtar	कमतर	कममत
kalamjeet	कमलजीत	कमलजीत
kamaljeet	कमलजीत	कमम्ीतत
kamaauu	कमाऊ	कमाौ
kamau	कमाऊ	कमौ
kamaate	कमाते	कमाते
kamate	कमाते	कममते
kamere	कमेरे	कमेरे
kmere	कमेरे	केररर
karanj	करंज	काां
kranj	करंज	क्ां
karanjiya	करंजिया	करणजीय
kardhe	करघे	कर््े
karghe	करघे	करर्े
karachana	करछना	करााा
karchhana	करछना	कर््ााा
karna	करना	करणन
karpatri	करपात्री	करपपत्री
karam	करम	काा
karoor	करूर	करूर
karur	करूर	कररर
karnataka	कर्नाटका	कारनाकका
karvi	कर्वी	करववी
kurvi	कर्वी	कुरवी
kalmein	कलमें	कललमे
kalmen	कलमें	कललमे
kalraj	कलराज	कलराज
kalika	कलिका	कलीका
kalpanaon	कल्पनाओं	कल्पनाओं
kalpnaon	कल्पनाओं	कल्पननओं
kavvaliyon	कव्वालियों	कवववालययों
qawwaliyon	कव्वालियों	क्ववालियों
kavvali	कव्वाली	कवववाली
qawwali	कव्वाली	कव्वाली
kashton	कष्टों	का्टों
kasarat	कसरत	कसरत
kasrat	कसरत	कसरतत
kasara	कसारा	कसराा
kasida	कसीदा	कसीदा
kahane	कहने	कहान
kahne	कहने	कहने
kahlaya	कहलाया	कहलाया
kahaniyon	कहानियों	कहहनियों
kile	क़िले	किलले
kanji	कांजी	कांजी
cant	कांट	कांट
kant	कांट	कांट
kanti	कांति	कांती
kakoo	काकू	काकू
kaku	काकू	कककु
kaagaj	कागज़	कागज
kaagaz	कागज़	कागज़
kagaj	कागज़	कागज
kagaz	कागज़	कागज़
kaaji	काजी	काजी
kaji	काजी	काजी
kazi	काजी	काजी
qazi	काजी	काजीी
kajoo	काजू	काजू
kaju	काजू	कजज
kapadi	कापड़ी	कपपडीी
kapdi	कापड़ी	कापड़ी
kamraj	कामराज	कममराज
kamottejana	कामोत्तेजना	कममोत्तेनाा
kamottejna	कामोत्तेजना	कममोत्तेजन
kailana	कायलाना	कैलनन
kaylana	कायलाना	कायलन
carfi	कार्की	कारफफी
karki	कार्की	कारककी
kartik	कार्तिक	कार्तिक
karyakartaon	कार्यकर्ताओं	कार्यकारततओं
karykartaaon	कार्यकर्ताओं	कार्यकारततओं
karykartaon	कार्यकर्ताओं	कार्यकारततओं
karyabhar	कार्यभार	कार्यभरर
karybhar	कार्यभार	कार्यभार
karyarat	कार्यरत	करर्यात
karyrat	कार्यरत	करर्यरत
kaalpi	कालपी	कालपी
kalapi	कालपी	कललपी
kalpi	कालपी	कल्पी
kalika	कालिका	कललिका
kalighat	कालीघाट	कालीघाट
coldvel	काल्डवेल	कॉ््वललल
kaldvel	काल्डवेल	काल्डवेल
kaldwell	काल्डवेल	कल्््वलल
kaav	काव	काव
kav	काव	कवव
kaasht	काश्त	काश्ट
kasht	काश्त	काषतट
kasim	कासिम	कससिम
qasim	कासिम	कासिम
kasimabad	कासिमाबाद	कासिमाबाद
kiya	किया	किया
kiliyan	किलियन	किलिया
killat	किल्लत	किल्टट
killi	किल्ली	किल्ली
kisaani	किसानी	किसानी
kisani	किसानी	किसननी
kisanon	किसानों	किसननों
keede	कीड़े	कीड़
kide	कीड़े	किड़े
keynote	कीनोट	केनोटे
kinote	कीनोट	किनोते
kiratpur	कीरतपुर	किरतपुर
kundal	कुंडल	कुंडल
kundaliya	कुंडलियाँ	कुंडलिया
kundaliyan	कुंडलियाँ	कुंदलियां
kutta	कुत्ता	कुट्त
kuposhit	कुपोषित	कुपोषित
kumau	कुमाऊ	कुमौ
kumavat	कुमावत	कुमावत
kumawat	कुमावत	कुमावत
kural	कुराल	कुराल
kurmi	कुर्मी	कुर्मी
kursiyon	कुर्सियों	कुरससियों
kush	कुश	कुश
kushaan	कुषाण	कुषाण
kushan	कुषाण	कुशण
kusumalataa	कुसुमलता	कुसुमलता
kusumalta	कुसुमलता	कुसुमलता
kusumlata	कुसुमलता	कुसुमलला
koot	कूट	कूट
kut	कूट	कुट
kritika	कृतिका	कृतिका
kpo	केपीओ	कपपो
canterbari	कैंटरबरी	कंंटरबार
canterbury	कैंटरबरी	कैंटरबरी
candidate	कैंडिडेट	कंंडिटटट
katrina	कैटरीना	कैटरीना
caitlyn	कैटलिन	कैटलिन
cateline	कैटलिन	कैटेलनन
catlin	कैटलिन	कैटलिन
cadmium	कैडमियम	कैममियम
catholic	कैथोलिक	कैथललिक
catholicon	कैथोलिकों	कैथललिको
kaetholikon	कैथोलिकों	काठठलिकों
capacitor	कैपेसिटर	कैपाििटर
carat	कैरेट	कैरेट
cavity	कैविटी	काविती
cavalry	कैवेलरी	कावार्ी
kaivelari	कैवेलरी	कावेलरर
complex	कॉम्प्लेक्स	कॉप्ल्क्क
kocchi	कोच्चि	कोचच
kochi	कोच्चि	कोची
corridor	कोरिडोर	करररडोर
corolla	कोरोला	कोरोल्
korola	कोरोला	कोरोला
caolan	कोलन	कॉलन
colan	कोलन	कोलन
colon	कोलन	कॉलन
calling	कोलिंग	कैलिंग
koling	कोलिंग	कोलिंग
colorado	कोलोराडो	कॉलाडो
kolorado	कोलोराडो	कोलोराडो
kaushal	कौशल	कौशल
kaushalata	कौशलता	कौशलता
kaushalta	कौशलता	कौशलता
kaushambi	कौशाम्बी	कौशंबी
cute	क्यूट	कटट
quete	क्यूट	क्वेटे
cube	क्यूब	क्यूब
cubeck	क्यूबेक	कबबकक
quebec	क्यूबेक	क्यूबेक
cubes	क्यूब्स	कबबसस
krantiyon	क्रांतियों	क्रंंिियों
cric	क्रिक	क्रिक
crick	क्रिक	क्रिक
cricket	क्रिकेट	क्रिकटट
cricketer	क्रिकेटर	क्रिकटटर
cricketing	क्रिकेटिंग	क्रिकेटेंग
kriyayog	क्रियायोग	कृरियायोग
christian	क्रिश्चयन	च्रिस्टिा
kruger	क्रूगर	क्ररर
craig	क्रेग	क्राग
creg	क्रेग	क्रेग
cradle	क्रैडल	क्रेडल
chrom	क्रोम	च्रोम
chrome	क्रोम	क्रोम
client	क्लांइट	क्लीइटट
clock	क्लाक	क्लॉक
clasen	क्लासें	क्लासन
classen	क्लासें	क्लाससं
classon	क्लासों	क्लासनन
clay	क्ले	क्ला
claris	क्लेरिस	क्लेरिस
cleris	क्लेरिस	क्लेरिस
clerys	क्लेरिस	क्लेरीज
quantico	क्वांटिको	क्वांटिको
queens	क्वींस	क्वीनस
kshitij	क्षितिज	क्षितिज
shitij	क्षितिज	शितिति
kshin	क्षीण	क्षिन
shin	क्षीण	शीन
kshetron	क्षेत्रों	क्षेत्रों
shetron	क्षेत्रों	श्षेत्रों
khand	खंडा	खाड
khanda	खंडा	खाडड
khachakhach	खचाखच	खचकचच
khajarana	खजराना	खजाराा
khajraana	खजराना	खजरााा
khajrana	खजराना	खजरराा
khatakati	खटकती	खटकती
khatakti	खटकती	खटकती
kihatkati	खटकती	किहतकति
khattapan	खट्टापन	खट्तपनन
khat	खत	खत
khani	खनि	खाी
khanik	खनिक	खानक
khanikarm	खनिकर्म	खानकररम
khanikarma	खनिकर्म	खािकामम
khanikarmi	खनिकर्म	खानकाममी
khapat	खपत	खपपत
khariya	खरिया	खरीया
khalnayak	खलनायक	खलनायक
khaaskar	ख़ासकर	खासककर
khaskar	ख़ासकर	खसस्कर
khaastaur	ख़ासतौर	खाससतौर
khastaur	ख़ासतौर	खससतौौर
khaibar	ख़ैबर	खैबबर
khyber	ख़ैबर	ख््बर
khaein	खाएं	खाईं
khaen	खाएं	खानं
khayen	खाएं	खाएं
khaate	खाते	खाते
khaatey	खाते	खाटे
khate	खाते	खटटे
khal	खाल	खाल
khinchakar	खिंचकर	खिंचकर
khinchkar	खिंचकर	खिंचकर
khilana	खिलाना	खिलाना
khinchkar	खींचकर	खिंचकर
khuda	खुदा	खुडा
khudai	खुदाई	खुडाई
khurapka	खुरपका	खुरपका
khurpaka	खुरपका	खुरपका
khurasan	खुरासान	खुरससनन
khushiyan	खुशियां	खुशियां
khene	खेने	खेने
khaini	खैनी	खैनी
khairati	खैराती	खैरतती
khoikhoi	खोईखोई	खोखखोई
khoya	खोया	खोया
gangrel	गंगरेल	गंग्ेे
gangaajal	गंगाजल	गंगाजल
gangajal	गंगाजल	गंगाजल
gandaki	गंडकी	गंदकक
gandki	गंडकी	गंडकक
gandh	गंध	गंध
gandha	गंध	गंधाा
gae	गए	गा
gaye	गए	गयये
gajara	गजरा	गजाा
gajra	गजरा	गजरा
gadkar	गडकर	गड़ककर
ganapati	गणपति	गणपति
ganpati	गणपति	गंपती
gatisheel	गतिशील	गतिशील
gatishil	गतिशील	गतिशिल
gatishilata	गतिशीलता	गतिशिलता
gadadhar	गदाधर	गदाधर
gammat	गम्मत	गमममत
gaya	गया	गया
garibi	गरीबी	गरिबी
garjana	गर्जना	गर्जना
galgand	गलगंड	गलगगं
gahmagahmi	गहमागहमी	गहमगगमीी
gemhagehmi	गहमागहमी	गेमहहहममम
ganguly	गांगुली	गंगगुली
gaanth	गांठ	गांठ
ganth	गांठ	गंठठ
gaanthe	गांठे	गांठे
ganthe	गांठे	गांठे
ganthen	गांठें	गंठठें
ganthon	गांठों	गंठठों
gaen	गाएं	गैएं
gayen	गाएं	गाएं
gazi	गाज़ी	गजजीी
gajipur	गाजीपुर	गाजीपुर
gazipur	गाजीपुर	गजजीपुर
gayatri	गायत्री	गययत्री
gayitri	गायत्री	गायत्री
gaytri	गायत्री	गय्त्री
gidgidate	गिड़गिड़ाते	गिजिििटटत
ginate	गिनते	गिनते
ginte	गिनते	गिंते
girkar	गिरकर	गिरकर
girijaghar	गिरजाघर	गिरिजघर
girjaghar	गिरजाघर	गिरजाघर
girijagharon	गिरजाघरों	गिरिजघररो
girjagharon	गिरजाघरों	गिरजजघररो
girati	गिरती	गिरती
girti	गिरती	गिरती
girish	गिरीश	गिरिश
guan	गुआन	गुआन
gujar	गुजार	गुजरर
gujarata	गुजारता	गुजररता
gujarta	गुजारता	गुजररता
gujarate	गुजारते	गुजररते
gujarte	गुजारते	गुजररते
gujarana	गुजारना	गुजररना
gujarna	गुजारना	गुजररना
gujara	गुजारा	गुजररा
gujare	गुजारे	गुजररे
gutta	गुट्टा	गुट्टा
gthalidar	गुठलीदार	ग्लिदारर
guthalidar	गुठलीदार	गुठललदार
gudna	गुदना	गुडना
gumaan	गुमान	गुमान
guman	गुमान	गुमान
gulshan	गुलशन	गुलशन
gunga	गूंगा	गुंगा
grihnagar	गृहनगर	गृहनगर
gruhnagar	गृहनगर	गृहागर
galaxion	गैलेक्सियों	गलल्किशननन
galaxiyon	गैलेक्सियों	गललककिसियों
galaxyon	गैलेक्सियों	गललकक्््यों
gochar	गोचर	गोचर
gouchar	गोचर	गोचर
godara	गोदारा	गोडररा
gopichand	गोपीचंद	गोपीचंद
gomake	गोमके	गोमके
gomke	गोमके	गोमके
goel	गोयल	गोलल
goyal	गोयल	गोयल
gosvaami	गोस्वामी	गोस्वामी
gosvami	गोस्वामी	गोस्वामी
goswami	गोस्वामी	गोस्वामी
gaumukh	गौमुख	गौमुख
gomukh	गौमुख	गोमुख
gaumutr	गौमूत्र	गौमुत्र
gaumutra	गौमूत्र	गौमुत्र
gowmutra	गौमूत्र	गौमूत्र
granthiyaan	ग्रंथियां	ग्राठियां
granthiyan	ग्रंथियां	ग्रंथियां
grandhiyon	ग्रंथियों	ग्रंथियों
granthiyon	ग्रंथियों	ग्रांियों
greest	ग्रीस्ट	ग्रीस्ट
greist	ग्रीस्ट	ग्रेस्ट
grist	ग्रीस्ट	ग्रिस्ट
greg	ग्रेग	ग्रेग
granite	ग्रेनाइट	ग्रेनाइट
grenite	ग्रेनाइट	ग्रेनितट
grandson	ग्रैंडसन	ग्रांडसो
gross	ग्रॉस	ग्रोस
ghataatop	घटाटोप	घटातोप
ghatatop	घटाटोप	घटटतोप
ghataayaa	घटाया	घटाया
ghataya	घटाया	घटाया
ghanakar	घनाकार	घनाकरर
ghabrahat	घबराहट	घबररहत
ghasi	घासी	घससी
ghisai	घिसाई	घिसाई
ghisi	घिसी	घिसी
ghise	घिसे	घिसे
ghumakkadi	घुमक्कड़ी	घुमक्काीी
ghumakkdi	घुमक्कड़ी	घुमक्कदीी
ghumakkadon	घुमक्कड़ों	घुमक्काोों
ghumakkaron	घुमक्कड़ों	घुमक्कररों
ghumakkdon	घुमक्कड़ों	घुमक्कडोों
ghummakkadon	घुमक्कड़ों	घुमम्कककों
ghumaan	घुमाण	घुमाण
ghuman	घुमाण	घुमाण
ghoonsa	घूंसा	घूंसा
ghunsa	घूंसा	घुणसा
ghongha	घोंघा	घोंघा
ghontane	घोंटने	घोंटनन
ghontne	घोंटने	घोंटने
ghot	घोट	घोट
ghodi	घोड़ी	घोड़ी
ghost	घोस्ट	घोस्ट
changul	चंगुल	चागगल
chand	चंद	चंड
chandan	चंदन	चंदन
chandana	चंदन	चंडना
chandu	चंदू	चंदू
chandon	चंदों	चंडों
chandrabali	चंद्रबली	चंद्रबली
chandramaon	चंद्रमाओं	चंद्रमाओं
chakatte	चकत्ते	चकततते
chaktte	चकत्ते	चक्तते
chakkar	चक्कर	चक्कर
chkkar	चक्कर	चक्कर
chakshu	चक्षु	चक्षष
chatagaon	चटगांव	चतागाओ
chatgaon	चटगांव	चत्गा
chadhane	चढ़ने	चढ़ने
chadhne	चढ़ने	चढ़ने
chaturdik	चतुर्दिक	चटुर्दिक
chatunshkoniy	चतुष्कोणीय	चतुंंंकोोय
chatushkoniy	चतुष्कोणीय	चतुष्कोणीय
chatushkoniya	चतुष्कोणीय	चतुष्कोोिय
channa	चन्ना	चननना
chabate	चबाते	चबबते
chabutare	चबूतरे	चबबततर
chabutre	चबूतरे	चबबत्र
chamakna	चमकना	चमकना
chamkana	चमकना	चमकाा
charas	चरस	चासस
charit	चरित	चरित
charcha	चर्चा	चर्चा
churcha	चर्चा	चर्चा
charchaon	चर्चाओं	चा्चाओं
chalenge	चलेंगे	चलेंगे
chlenge	चलेंगे	च्लेगे
chahunaur	चहुंओर	चहुनौर
chahunor	चहुंओर	चहुनोर
chanval	चांवल	चाववल
chanwal	चांवल	चानवल
chachaji	चाचाजी	चचचाीी
chadar	चादर	चड़र
chadaron	चादरों	चडडरों
chadron	चादरों	चड््रं
chan	चान	चा
chanan	चानन	चान
chaplusi	चापलूसी	चपलसससी
chayal	चायल	चायल
char	चार	चार
charon	चारों	चारों
charge	चार्ज	चार्ज
chart	चार्ट	चरर्ट
charton	चार्टों	चार्टों
charts	चार्ट्स	चार्ट्स
chaalit	चालित	चालित
chalit	चालित	चललतत
chikitsak	चिकित्सक	चिकित्सक
chikitsakon	चिकित्सकों	चिकित्सकों
chikhali	चिखली	चिखली
chiththi	चिट्ठी	चितठठी
chitthi	चिट्ठी	चित्ठी
chithhi	चिठ्ठी	चिठह
chiththi	चिठ्ठी	चित्ठी
chitthi	चिठ्ठी	चित्ठी
chidchidapan	चिडचिडापन	चिडचिडापन
chidchidapan	चिड़चिड़ापन	चिड़चिदाप
chidhate	चिढ़ते	चिढ़ात
chidhte	चिढ़ते	चिढ़ते
chithrkar	चित्रकार	चित्रकरर
chitrkar	चित्रकार	चित्रकार
chipakane	चिपकने	चिपकने
chipakne	चिपकने	चिपकने
chipkane	चिपकने	चिपकाे
chimati	चिमटी	चिमती
chimti	चिमटी	चिमती
chillane	चिल्लाने	चिल्लनन
chee	ची	ची
chi	ची	ची
chuka	चुका	चुका
chune	चुने	चुने
chunar	चूनर	चुनर
changed	चेंज्ड	चांगेड
chetti	चेट्टी	चेट्टी
chennai	चेन्नई	चेनेनी
chero	चेरो	चेरो
chest	चेस्ट	चेस्ट
championship	चैंपियनशिप	चापपिंशिपप
chor	चोर	चोर
choro	चोरों	चोरो
choron	चोरों	चोरों
chauk	चौक	चौक
chowk	चौक	चौक
chauka	चौका	चौका
chuka	चौका	चुका
chaukiyan	चौकियां	चौकियां
chauki	चौकी	चौकी
chaukhate	चौखटे	चौखते
chauguni	चौगुनी	चौगुनी
chauda	चौड़ा	चौडाा
chaudah	चौड़ा	चौड़
chaudahavan	चौदहवां	चौदावान
chaudhavan	चौदहवां	चौधावान
chaudhawan	चौदहवां	चौधावान
chaupati	चौपाटी	चौपतती
chupaty	चौपाटी	चुपतती
chaupal	चौपाल	चौपाल
chaurai	चौरई	चौरा
chausinga	चौसिंगा	चौसिंगा
chausingha	चौसिंगा	चौसिंहह
chhagan	छगन	छागन
chhabi	छबि	छाी
chhalla	छल्ला	छललला
chhallaa	छल्ला	छललाा
chhaviyaan	छवियाँ	छावििा
chhaviyan	छवियाँ	छावििन
chhavi	छवी	छावी
cheh	छह	चेह
chhah	छह	छाह
chehon	छहों	चेहो
chhahon	छहों	छहहो
chhai	छाई	छाई
chhagla	छागला	छागला
chhajan	छाजन	छाजन
chhaati	छाती	छाती
chhati	छाती	छाती
chhaapemaar	छापेमार	छापेमार
chhapemar	छापेमार	छपपेमरर
chheenk	छींक	छीनक
chhink	छींक	छींक
chink	छींक	छींक
chenkein	छींके	चेंकें
chhekein	छींके	छेककें
chhinke	छींके	छिनके
chhinky	छींके	छिनकी
chinke	छींके	छींके
chhudaane	छुडाने	छुड़ने
chhudane	छुडाने	छुड़ने
chhupakar	छुपकर	छुपका
chhupkar	छुपकर	छुपकर
chhupkr	छुपकर	छुपक्
chhupata	छुपता	छुपता
chhupta	छुपता	छुप्ा
chhuptaa	छुपता	छुपता
chhura	छुरा	छुरा
chhuraa	छुरा	छुरा
chhuree	छुरी	छुरी
chhuri	छुरी	छुरी
chhure	छुरे	छुरे
chhootane	छूटने	छूटने
chhutane	छूटने	छुटने
chhutne	छूटने	छुटने
chheter	छेत्र	छेटरर
chhetr	छेत्र	छेत्र
chhetter	छेत्र	छेट्र
chhetri	छेत्री	छेततरी
chhetthari	छेत्री	छेत्ररी
chhetthri	छेत्री	छेत्री
chai	छै	चा
chhai	छै	छा
chhe	छै	छे
jagaega	जगाएगा	जगागगा
jagayega	जगाएगा	जगाएगा
jaghaega	जगाएगा	जगहएगा
jgaayega	जगाएगा	जगाएगा
jgayegaa	जगाएगा	जगयएगा
jajaon	जजों	जजाओं
jajon	जजों	जजोो
jad	जड़	जाड
jadd	जड़	जाड्
jaddit	जड़ित	जड़ित
jadeite	जड़ित	जड़ेते
jadet	जड़ित	जड़ेत
jadit	जड़ित	जड़ित
jadein	जड़ें	जड़ें
jaden	जड़ें	जड़ें
jatara	जतरा	जतार
jatra	जतरा	जत्ा
jataati	जताती	जताती
jatatee	जताती	जततती
jatati	जताती	जततती
janagananaa	जनगणना	जनगनना
janaganna	जनगणना	जनगानन
jangadnaa	जनगणना	जागादाा
janganana	जनगणना	जागनना
janganna	जनगणना	जागननन
janajagran	जनजागरण	जनजजग्र
janjaagran	जनजागरण	जनजाग्ण
janjagran	जनजागरण	जनजागरण
january	जनवरी	जननार
janahaani	जनहानि	जनहानि
janahani	जनहानि	जनहहनी
janhaani	जनहानि	जनहहनी
janhani	जनहानि	जनहननी
jnhaani	जनहानि	जहहानी
jamaate	जमाती	जमाती
jamaati	जमाती	जमाती
jamati	जमाती	जमतती
jamaaya	जमाया	जमाया
jamaeya	जमाया	जमाएा
jamaya	जमाया	जमाया
jamayaa	जमाया	जमाया
jamuai	जमुई	जमुई
jamuei	जमुई	जमुू
jamui	जमुई	जमुी
jai	जय	जा
jay	जय	जय
jaidayal	जयदयाल	जैदााल
jayadayal	जयदयाल	जयदााल
jaydayal	जयदयाल	जयदयाल
jaibaan	जयबाण	जैबान
jaiban	जयबाण	जयबाण
jaybaan	जयबाण	जयबान
jayalalita	जयललिता	जयललिता
jayalalitaa	जयललिता	जयललिता
jayalalithaa	जयललिता	जयललिठा
jaylalita	जयललिता	जयलािता
jarakh	जरख	जरख
zarakh	जरख	ज़खा
jarda	जर्दा	जर्द
jardaa	जर्दा	जरदाा
zarda	जर्दा	जर्द
jalagati	जलगति	जलगती
jalgati	जलगति	जलगती
jalgti	जलगति	जलगती
jalte	जलते	जलते
jalbharav	जलभराव	जलभराव
jalbhraav	जलभराव	जलभराव
jalbhrav	जलभराव	जलभरवव
jalvaayu	जलवायु	जलवायु
jalvayu	जलवायु	जलवायु
jalesar	जलेसर	जलेसर
jasmeet	जसमीत	जसमीत
jasmit	जसमीत	जसममत
jassee	जस्सी	जससीी
jassi	जस्सी	जसससी
jamaanaa	ज़माना	जमााना
jamana	ज़माना	जममाा
zamaanaa	ज़माना	जमााना
zamana	ज़माना	ज़माा
jaljale	ज़लज़ले	जलजजलेे
zalzale	ज़लज़ले	जललझलले
zee	ज़ी	जी
jubaan	ज़ुबान	जुबबान
juban	ज़ुबान	जुबा
zuban	ज़ुबान	ज़ुबान
jaanch	जाँच	जांच
jaaunch	जाँच	जांच
janch	जाँच	जांच
jaunch	जाँच	जांच
jaagriti	जागृति	जाग्ति
jagriti	जागृति	जगरृति
jagruti	जागृति	जगरृति
jajamau	जाजमऊ	जाजमऊ
jajmau	जाजमऊ	जाजमऊ
jajmauu	जाजमऊ	जजममौ
jaat	जात	जात
jat	जात	जाट
jaatak	जातक	जातक
jatak	जातक	जाकक
jaatakon	जातकों	जातकों
jaatkon	जातकों	जातकों
jatakon	जातकों	जाककों
jaatiyon	जातियों	जातियों
jatiyon	जातियों	जातियों
jaankaaron	जानकारों	जानकारों
jaankaron	जानकारों	जानकररों
jankaron	जानकारों	जनककररों
jaanam	जानम	जानम
janam	जानम	जनमम
jaayke	जायके	जायके
jayke	जायके	जययके
jaawar	जावर	जावर
zawar	जावर	ज़वर
jing	जिंग	जिंग
gin	जिन	जिन
jeen	जिन	जीन
jin	जिन	जिन
ginee	जिनी	गिनी
jinee	जिनी	जिनी
jini	जिनी	जिनी
geneva	जिनीवा	गेनेवा
jeneva	जिनीवा	जेनेवा
jiniva	जिनीवा	जिनिवा
gypsy	जिप्सी	जिप्सी
jimme	जिम्मे	जिम्म
jiya	जिया	जिया
gic	जीआईसी	जीसीसी
gr	जीआर	ग्गर
gm	जीएम	एएएम
gsm	जीएसएम	एीएसएम
gtod	जीतोड़	गटटोड
gtor	जीतोड़	ग्टोर
jeetod	जीतोड़	जीतोड
jitod	जीतोड़	जितोड
jean	जीन	जीन
jeen	जीन	जीन
jin	जीन	जिन
jeenon	जीनों	जीनों
jinon	जीनों	जिनों
jeepney	जीपनी	जीपने
jipani	जीपनी	जिपनन
jeeyo	जीयो	जीयो
jio	जीयो	जियो
jiyo	जीयो	जियो
jeera	जीरा	जीरा
jira	जीरा	जिरा
jeevant	जीवंत	जीवंं
jivant	जीवंत	जीवां
jeevan	जीवन	जीवन
jeewan	जीवन	जीवा
jivan	जीवन	जीवन
jiwan	जीवन	जीवन
jeevanshaili	जीवनशैली	जीवंशलली
jivanshaili	जीवनशैली	जीवाशाली
jeevniyaan	जीवनियां	जीवननयां
jivaniya	जीवनियां	जीवनिया
jivaniyaan	जीवनियां	जीवनियां
jivaniyan	जीवनियां	जीवनियां
jeevraaj	जीवराज	जीवराज
jivraj	जीवराज	जीवराज
jua	जुए	जुआ
jue	जुए	जूए
juye	जुए	जुए
jutee	जुटी	जुटी
juti	जुटी	जुटी
judaai	जुड़ाई	जुडाईई
judae	जुड़ाई	जुड़
judai	जुड़ाई	जुड़ईई
judaai	जुदाई	जुडाई
judai	जुदाई	जुडाई
junoon	जुनून	जुनून
junun	जुनून	जुनुन
junooni	जुनूनी	जुनूनी
jununi	जुनूनी	जुनुनी
jubair	जुबेर	जुबैर
juber	जुबेर	जुबरर
zubair	जुबेर	जुबार
juraab	जुराब	जुराब
jurab	जुराब	जुराब
julaahon	जुलाहों	जुलाहों
julahon	जुलाहों	जुलहहों
julmon	जुल्मों	जुलममों
zulmon	जुल्मों	जुलममों
jood	जूड	जूड
jud	जूड	जूड
junagadh	जूनागढ	जुनगगढ़
junagarh	जूनागढ	जूनागढ
junior	जूनियर	जुनियर
jealous	जूलूस	जेलोस
juloos	जूलूस	जुलूस
julus	जूलूस	जुलसस
jetha	जेठा	जेठा
jenner	जेनर	जेन्
generic	जेनरिक	जेनेरि
jenrick	जेनरिक	जेनररकक
generat	जेनरेट	गेनेेट
generate	जेनरेट	गेनेेे
jenee	जेनी	जेनी
jenni	जेनी	जेनन
jenny	जेनी	जेन्
james	जेम्स	जैमेस
jeremy	जेरेमी	जेरेमी
gerome	जेरोम	गररोम
jerome	जेरोम	जेरोम
jacks	जैक्स	जैक्स
jain	जैन	जैन
gene	जैने	गेनन
jaine	जैने	जैने
jaino	जैनों	जैनो
jainon	जैनों	जैनों
jerry	जैरी	जेरी
jasper	जैस्पर	जैस्पर
jogging	जॉगिंग	जोगिगग
johnson	जॉनसन	जोनसों
jobs	जॉब्स	जॉस्स
jockey	जोकि	जॉके
joki	जोकि	जोकी
jokhim	जोखिम	जोखिम
joddta	जोड़ता	जोड़ता
jodta	जोड़ता	जोड़ता
jorhta	जोड़ता	जोऱता
jodiyon	जोड़ियों	जोडिियों
jodo	जोड़ो	जोड़
jaun	जौं	जौं
gyatavya	ज्ञातव्य	ज्ञातव्य
gyatvy	ज्ञातव्य	ज्ञात््य
gyapit	ज्ञापित	ज्ञापित
jyotiba	ज्योतिबा	ज्योतिबा
joint	ज्वाइंट	जॉइंटट
jvar	ज्वार	ज्वरर
jwar	ज्वार	ज्वार
jvaaron	ज्वारों	ज्वारों
jvaron	ज्वारों	ज्वररों
jwaron	ज्वारों	ज्वारों
jewellers	ज्वेलर्स	ज्वेल््स
jh	झ	ज
jha	झ	झा
jhalakti	झलकती	झलक्ी
jhalkati	झलकती	झलकती
jhalla	झल्ला	झल्ला
jhankana	झांकना	झंकका
jhankna	झांकना	झंकना
jheel	झील	झील
jhil	झील	झिल
jheelon	झीलों	झीलों
jhilon	झीलों	झिलों
jhuthala	झुठला	झुठला
jhuthla	झुठला	झुठला
jhuthalane	झुठलाने	झुठलनने
jhuthlane	झुठलाने	झुठलाने
tankaar	टंकार	टंकार
tankar	टंकार	तंककर
takara	टकरा	तकाा
takra	टकरा	तकरा
takaraon	टकरावों	तकराओंं
takravon	टकरावों	तकरावों
tapakti	टपकती	तपप्ी
tapkati	टपकती	तपककत
time	टाइम	टिइम
timer	टाइमर	टीइमर
taoo	टाऊ	ताओ
tau	टाऊ	ता
tapoowo	टापुओं	टापूू
tapuon	टापुओं	तैपूओं
tapuwo	टापुओं	टापुओं
tied	टायर्ड	टीइड
tired	टायर्ड	टिररेड
tyred	टायर्ड	ट्यरेड
tarch	टार्च	ता््च
torch	टार्च	टोर्च
tik	टिक	टिक
teap	टिप	टिप
tip	टिप	टीप
tippanikar	टिप्पणीकार	तिप्पणिककर
tippnikar	टिप्पणीकार	तिप्पनिकरर
tivolee	टिवोली	टिवोली
tivoli	टिवोली	टिवोली
teekamgarh	टीकमगढ़	टीकमगढ़
tikamgarh	टीकमगढ़	तिकामग़
teekon	टीकों	तीकों
tikon	टीकों	तिकों
two	टु	ट्व
tension	टेंशन	टेंसन
tenis	टेनिस	टेनिस
tennis	टेनिस	टेनिस
taste	टेस्ट	तसस्ट
test	टेस्ट	टेस्ट
tasting	टेस्टिंग	टास्टिंग
testing	टेस्टिंग	टेस्टिंग
tainin	टैनिन	तैनिन
tenin	टैनिन	टेननन
tanish	टैनिस	तानिश
tennis	टैनिस	टेनिस
taboo	टैबू	ताूू
taiboo	टैबू	तैइब
taobao	टैबू	ताबब
tonic	टॉनिक	टोनिक
tonga	टोंगा	टोंगा
toka	टोका	तोका
tuesday	ट्यूजडे	टुयूस्
tuning	ट्यूनिंग	टुनंनिंग
tuberculosis	ट्यूबरक्यूलोसिस	टुबूररर््कक्स
tuberkyulosis	ट्यूबरक्यूलोसिस	टुबूरर्््कल्स््
truck	ट्रक	ट्रकक
trangistor	ट्रांजिस्टर	ट्रांगिस्टर
tranjister	ट्रांजिस्टर	ट्राजजिस्टर
transistor	ट्रांजिस्टर	ट्रांसससटटर
transfer	ट्रान्सफर	ट्रांसफरर
tribunal	ट्रिब्युनल	ट्रिबुनलल
tribunal	ट्रिब्यूनल	ट्रिबुनलल
trubyunal	ट्रिब्यूनल	ट्रुबुननलल
truth	ट्रुथ	त्थ
tuth	ट्रुथ	ट्ठ
traded	ट्रेडेड	ट्रेडड
trabal	ट्रेबल	ट्रालल
trebal	ट्रेबल	ट्रेबल
trouble	ट्रेबल	ट्रेबल
traip	ट्रैप	ट्रैप
trap	ट्रैप	ट्रैप
trot	ट्रॉट	ट्रॉट
trott	ट्रॉट	ट्रॉट
thakkar	ठक्कर	ठकककर
thakkr	ठक्कर	ठक्कर
thaharne	ठहरने	ठहरने
thahrane	ठहरने	ठहराे
theharne	ठहरने	ठहररे
thikane	ठिकाने	ठिकाने
thumari	ठुमरी	ठुमाी
thumri	ठुमरी	ठूमरी
theinga	ठेंगा	ठेंगा
thenga	ठेंगा	ठेंगा
thengaa	ठेंगा	ठेंगा
daglas	डगलस	डगलस
douglas	डगलस	दोगाा
dabhara	डभरा	दारा
dabhra	डभरा	दारा
dabhoi	डभोई	डभोई
dam	डम	दाम
dum	डम	डम
darate	डराते	दरतते
daratey	डराते	दरतते
daravani	डरावनी	दरववनी
darawani	डरावनी	दरावनी
dravani	डरावनी	डरावनी
down	डाउन	दोउन
daak	डाक	दाक
dak	डाक	दकक
daka	डाका	दकका
dabi	डाबी	दबबी
dabolim	डाबोलिम	दबबोलिम
dinosaur	डायनासोर	दिनोससर
diaries	डायरीज	डायरीज
dit	डिट	दीट
depthiriya	डिप्थीरिया	डिप्थीरिया
diphtheria	डिप्थीरिया	दिफ्ठेरिया
de	डीई	डे
dealership	डीलरशिप	दिलरशशप
dvc	डीवीसी	डीवीसी
dubaana	डुबाना	दुबाना
dubana	डुबाना	दुबाना
dubona	डुबोना	दुबोना
dulne	डुलने	डुलने
doonarpur	डूंगरपुर	दूनरपुुर
doongarpur	डूंगरपुर	दूंगरपुर
dungarpur	डूंगरपुर	दंंगरपुर
dungerpur	डूंगरपुर	दंंग्पुर
dubana	डूबना	दुबाा
dubna	डूबना	दुबना
dangerous	डेंजरस	दागजररससससससससससससससससससससससससस
daisy	डेजी	दैस्
dazy	डेजी	दज््
deji	डेजी	देजी
deputy	डेप्युटी	डिपूट
davidson	डेविडसन	दाविडसों
devidson	डेविडसन	देविदसों
davey	डेवी	डेवी
devi	डेवी	देवी
dewey	डेवी	द्वी
destination	डेस्टिनेशन	डेस्टिनेशन
datson	डैटसन	दाटसोन
datsun	डैटसन	दाटसू
daddy	डैडी	दडद्य
dark	डॉर्क	डार्क
dork	डॉर्क	डोर्क
dose	डोज	डोस
domenic	डोमेनिक	डोमेनिक
doranda	डोरंडा	दोरंडा
dolane	डोलने	दोलने
dolne	डोलने	डोलने
dual	ड्युअल	ड्युअल
duak	ड्यूक	ड्यूक
duke	ड्यूक	डुके
drame	ड्रामे	ड्रामे
dramen	ड्रामे	ड्रममें
drager	ड्रेजर	ड्रेजर
dredger	ड्रेजर	ड्रेजर
dreijer	ड्रेजर	ड्रेजर
dhakaal	ढकाल	धकाल
dhakal	ढकाल	धकलल
dhakkal	ढकाल	धक्ा
dhkal	ढकाल	धका
dhale	ढले	ढलल
dhoondh	ढूंढ	धूंध
dhundh	ढूंढ	धुंध
dhoondhata	ढूंढता	धूंधता
dhundhata	ढूंढता	धुंधता
dhundhta	ढूंढता	धुंधता
dhoondhi	ढूंढी	धूंधी
dhundhi	ढूंढी	ढूंढी
tanjavur	तंजावुर	तंजावूर
thanjavur	तंजावुर	थंजावूर
tantr	तंत्र	तंत्र
tantra	तंत्र	तंत्र
tantrikao	तंत्रिकाओं	तंत्रिका
tantrikaon	तंत्रिकाओं	तंत्रिकाओं
tantro	तंत्रों	तंं्रों
tantron	तंत्रों	तंत्रों
tagade	तगड़े	तगग़े
tagde	तगड़े	तगड़े
tadipaar	तड़ीपार	तद़िपार
tadipar	तड़ीपार	ता़ीपार
tani	तनी	ताी
tapan	तपन	तपपन
tarafa	तरफा	तराा
tarfa	तरफा	तररफ
tarabganj	तरबगंज	तररगंं
taras	तरस	तरसा
taraash	तराश	तराशश
tarash	तराश	तराश
tarashay	तराशे	तरााय
tarashe	तराशे	तराेे
tareeko	तरीको	तरीकक
tariko	तरीको	टारकक
tark	तर्क	ता्क
tarkvaad	तर्कवाद	तर्कवाद
tarkvad	तर्कवाद	तर्कवाद
tarkwaad	तर्कवाद	तर्कााद
tarko	तर्कों	तरकको
tarkon	तर्कों	तरककों
talabgaar	तलबगार	तलाबार
talabgar	तलबगार	तलाबगर
talbagaar	तलबगार	तलबबगग
talbagar	तलबगार	तलबबगग
talawe	तलवे	तलवव
talve	तलवे	तलवे
talawon	तलवों	तलाों
talvon	तलवों	तलववं
tahakhana	तहखाना	तहखाना
tahkhaana	तहखाना	तहखाना
tahkhana	तहखाना	तहखाना
taantaa	तांता	तांता
tanta	तांता	तंंता
tambe	तांबे	तमबब
tanbe	तांबे	टंंब
taaja	ताजा	ताजा
taajaa	ताजा	ताजा
taaza	ताजा	ताजा
taja	ताजा	तजजा
taza	ताजा	तजजा
tansen	तानसेन	तंंसें
taapmaanon	तापमानों	तापममननं
tapmano	तापमानों	तपपमानों
tapmanon	तापमानों	तपपमानों
taapti	ताप्ती	ताप्ती
tapti	ताप्ती	तपप्ीी
tarabai	ताराबाई	तररबईईई
taseer	तासीर	ताीीर
tasir	तासीर	तासरर
taahi	ताहि	ताही
tahi	ताहि	तहही
tikone	तिकोने	टिकोन
tirupati	तिरूपति	तिरुपती
tiwari	तिवारी	तिवारी
ti	ती	टी
teer	तीर	टीर
tir	तीर	टीर
teeron	तीरों	तीरों
tiron	तीरों	तीरों
tirthatan	तीर्थाटन	तिर्थानन
tungnath	तुंगनाथ	तुंगनाथ
tughlaq	तुगलक	तुगलाा
tuglak	तुगलक	तुगलक
tughlakabad	तुगलकाबाद	तुगलकाबाद
tughlaqabad	तुगलकाबाद	तुगलााबाद
tuglakabad	तुगलकाबाद	तुगलकाबाद
tugalaki	तुगलकी	तुगलकक
tugalki	तुगलकी	तुगलकी
tuglaki	तुगलकी	तुगलकक
tufail	तुफैल	टुफैल
tejaji	तेजाजी	तेजाजी
teji	तेजी	तेजी
tel	तेल	टेल
telon	तेलों	टेलों
to	तो	टो
toh	तो	तो
taul	तौल	ताल
tyohaar	त्यौहार	त्यौहार
tyohar	त्यौहार	त्योहार
tyoihar	त्यौहार	त्यौहार
tyauharon	त्यौहारों	त्यौहारों
tyoharon	त्यौहारों	त्योहारों
tyoiharon	त्यौहारों	त्योयिहों
trijata	त्रिजटा	त्रिजटा
trijta	त्रिजटा	त्रितता
triya	त्रिया	त्रिया
tremasik	त्रैमासिक	ट्रेमाससक
trimasik	त्रैमासिक	ट्रिमाससक
tse	त्से	त्से
thaki	थकी	ठकी
thki	थकी	ठकी
tharti	थर्टी	ठरतती
thirty	थर्टी	थर्टी
thane	थाणे	थाणे
thaanvi	थानवी	थानवी
thanvi	थानवी	थानीी
theateron	थिएटरों	थेटटरों
theatron	थिएटरों	थिएटरों
theaters	थिएटर्स	थेटटर्स
theater	थियेटर	थेटररर
theatre	थियेटर	थेटत्रे
theateron	थियेटरों	थेटटररों
theatron	थियेटरों	थेट्ररों
thitron	थियेटरों	थित्रोों
theaters	थियेटर्स	थेटटर््स
theatrs	थियेटर्स	थियेटर्स
thiyeters	थियेटर्स	थिइटटर्स
thirake	थिरके	थिरकक
thirke	थिरके	थिरकक
thief	थीफ	थीफ
then	थेन	थेन
theni	थेनी	ठेनी
thailee	थैली	ठैली
thaili	थैली	ठैली
thaile	थैले	थैले
dang	दंग	डाग
danga	दंगा	दागा
dangon	दंगों	दागोो
dampati	दंपति	दापती
danpati	दंपति	दापती
dampatiyon	दंपतियों	दापतियों
dampattiyon	दंपतियों	दामत्तों
danptiyon	दंपतियों	दापतियों
dadreva	ददरेवा	दद््वा
dadrewa	ददरेवा	दद््वा
damoh	दमोह	दमोह
dardara	दरदरा	दरददा
dardraa	दरदरा	दरदरा
durdhara	दरदरा	दुर्धााा
darmiyaan	दरमियान	दर्मयाा
darmiyan	दरमियान	दर्मयां
darjano	दर्जनों	दर्जनों
darjanon	दर्जनों	दर्जनों
darp	दर्प	दर्प
darra	दर्रा	दर्रा
dalbadal	दलबदल	दलबबलल
dalbadl	दलबदल	डलबबलल
dali	दली	दली
dastaanaa	दस्ताना	दस्ताना
dastana	दस्ताना	दस्ताना
dastavej	दस्तावेज	दस्ततवेज
dahan	दहन	दहन
dahal	दहल	दहल
da	दा	दा
daakhil	दाखिल	दाखिल
dakhil	दाखिल	दखखलल
daakhile	दाखिले	दाखिले
dakhile	दाखिले	दाखिले
daataa	दाता	दाता
data	दाता	दताा
dadari	दादरी	दादरी
daanshil	दानशील	दांशिल
danshil	दानशील	दाशिलल
daabholkar	दाभोलकर	दाभोलकर
dabholkar	दाभोलकर	दभभोलकर
damale	दामले	दममेे
damle	दामले	डम्ले
dayitv	दायित्व	दायित्व
dayitva	दायित्व	दययित्व
dayitwa	दायित्व	दययित्ाा
dayitvon	दायित्वों	दययित्वों
dayityon	दायित्वों	दययित्यों
darul	दारूल	दररूल
daav	दाव	दाव
daaw	दाव	दाव
dav	दाव	देव
daw	दाव	दा
daah	दाह	दाह
dah	दाह	दाह
dikhla	दिखला	दिखला
dikhlaa	दिखला	दिखला
dikhaaiye	दिखाइये	दिखाइये
dikhaiye	दिखाइये	दिखाइए
dikhaai	दिखाई	दिखाई
dikhai	दिखाई	दिखाई
dikhayi	दिखाई	दिखाई
dikhaaee	दिखाईं	दिखाई
dikhaai	दिखाईं	दिखाई
dikhaain	दिखाईं	दिखाईं
dikhaee	दिखाईं	दिखाई
dikhai	दिखाईं	दिखाई
dikhayin	दिखाईं	दिखायं
dikhai	दिखायी	दिखायी
dikhayi	दिखायी	दिखाई
dikhaai	दिखार्इ	दिखाई
dikhae	दिखार्इ	दिखाई
dikhai	दिखार्इ	दिखाई
dikhayi	दिखार्इ	दिखाईी
dita	दिता	दिता
ditaa	दिता	दिता
dinaank	दिनांक	दिनानक
dinank	दिनांक	दिनांक
dirham	दिरहम	दिरहह
dilaaye	दिलाये	दिलाए
dilaye	दिलाये	दिलाए
deewani	दिवानी	दीवानी
diwani	दिवानी	दिवानी
divy	दिव्य	दिव्
divya	दिव्य	दिव्य
divyata	दिव्यता	दिव्यता
divya	दिव्या	दिव्य
deepan	दीपन	दीपन
deepn	दीपन	दीप्
dipan	दीपन	दिपा
deepsingh	दीपसिंह	दीप्ििह
dipsingh	दीपसिंह	दीपसिंह
deepika	दीपिका	दीपिका
dipika	दीपिका	दिपिका
deeya	दीया	दीया
diya	दीया	दिया
dukaanon	दुकानों	दुकानों
dukanon	दुकानों	दुकननों
dukke	दुक्के	डुक्के
dukhan	दुखन	दुखन
dukhit	दुखित	दुखित
dukhiyon	दुखियों	दुखियों
dukhon	दुखों	दुखों
dubhashiyon	दुभाषियों	दुभाषियों
durgun	दुर्गुण	दुर्गुण
durghatna	दुर्घटना	दुर्घटना
durghtna	दुर्घटना	दुर्घटना
duneerti	दुर्नीति	दुनीरत
durniti	दुर्नीति	दूर्णिति
durbhiksh	दुर्भिक्ष	दुर्भिक्ष
duvidhaaen	दुविधाएं	दुविधाएं
duvidhaayein	दुविधाएं	दुविधाएं
duvidhaen	दुविधाएं	दुविधाएं
duwaidhaayein	दुविधाएं	दुविधाएं
dune	दूने	डुने
doordarshan	दूरदर्शन	दूरदर्शन
durdarshan	दूरदर्शन	दूरदर्शन
dradh	दृढ़	द्ा़
dridh	दृढ़	दृद्ध
dekhoge	देखोगे	डेखोगे
denevaali	देनेवाली	देनेवाली
denevali	देनेवाली	देनेवाली
denewaali	देनेवाली	देनेवाली
denewali	देनेवाली	देनेवाली
deonar	देवनार	देयनरर
devnaar	देवनार	देवनार
devnar	देवनार	देवनार
devaapur	देवापुर	देवापुर
devapur	देवापुर	देवापुर
devi	देवी	देवी
devisingh	देवीसिंह	देविसिंह
devisinh	देवीसिंह	देविसिहह
deshkaal	देशकाल	देशकाल
deshkal	देशकाल	देशकाल
deshke	देशके	देशके
desai	देसाई	देसाई
doge	दोगे	डोगे
dvadash	द्वादश	द्वाशश
dwaadas	द्वादश	द्वादस
dvivedi	द्विवेदी	द्विवेदी
dwivedi	द्विवेदी	द्विवेदी
dhande	धंधे	धंडे
dhandhe	धंधे	धंधे
dhndhe	धंधे	धंधे
dhandhon	धंधों	धंधोो
dhandon	धंधों	धाडों
dhakelte	धकेलते	धकेलते
dhkelate	धकेलते	धकेेेे
dhatana	धटना	धटना
dhatna	धटना	धतना
dhankuber	धनकुबेर	धंकुबरर
dhanadhany	धनधान्य	धनाान्य
dhandhaanya	धनधान्य	धनधान्य
dhandhany	धनधान्य	धंधान्य
dhandhanya	धनधान्य	धनधान्य
dhamkaataa	धमकाता	धमकाता
dhamkata	धमकाता	धमकतता
dhamm	धम्म	धम्म
dhamma	धम्मा	धम्मा
dhammaa	धम्मा	धमममा
dharmnath	धर्मनाथ	धर्ममाथ
dharmraj	धर्मराज	धर्मराज
dharmesh	धर्मेश	धर्मेश
dhasmaanaa	धस्माना	धस्माना
dhasmana	धस्माना	धस्माना
dhaak	धाक	धाक
dhak	धाक	धक
dhaaga	धागा	धागा
dhaagaa	धागा	धागा
dhaga	धागा	ढगगा
dhaatuein	धातुएं	धातूएं
dhaatuyein	धातुएं	धातुयी
dhtuen	धातुएं	ध्तूएं
dhaarak	धारक	धारक
dharak	धारक	धरकक
dhaari	धारी	धारी
dhari	धारी	धारी
dhuan	धुआं	धुआं
dhunaai	धुनाई	धुनाई
dhunai	धुनाई	धुनाई
dhuriya	धुरिया	धुरिया
dhuriyaa	धुरिया	धुरिया
dhuni	धूनी	धूनी
dhairyavaan	धैर्यवान	धैर्यवान
dhairyawan	धैर्यवान	धैर्यवान
dhiryavan	धैर्यवान	धिर्याान
dhiryawaan	धैर्यवान	धिर्याान
dhokebaaj	धोखेबाज	धोखेबाज
dhokebaaz	धोखेबाज	धोकेबाज
dhokebaj	धोखेबाज	धोखेबाज
dhokebaz	धोखेबाज	धोकेबाज
dhokhebaaj	धोखेबाज	धोखेबाज
dhokhebaj	धोखेबाज	धोखेबाज
dhona	धोना	ढोना
dhonaa	धोना	धोना
dhoraaji	धोराजी	धोराजी
dhoraji	धोराजी	धोराजी
dhoron	धोरों	धोरों
dhyeyavaadi	ध्येयवादी	ध्येयवादी
dhyeywadi	ध्येयवादी	ध्येयवादी
dyeyvadi	ध्येयवादी	द्येवाादी
dhrupad	ध्रुपद	ध्रुपद
drupad	ध्रुपद	द्राप
nandanvan	नंदनवन	नंदनननन
nadsa	नक्सल	नदससा
naksal	नक्सल	नक्सल
naxal	नक्सल	नै्सा
naksalavaad	नक्सलवाद	नक्सलााद
naksalwaad	नक्सलवाद	नक्सलवाद
naksalwad	नक्सलवाद	नक्सलवाद
naxalvaaad	नक्सलवाद	नै्सालााा
naxalwaad	नक्सलवाद	नै्साााा
naksaliyon	नक्सलियों	नक्सलियों
naxaliyon	नक्सलियों	नै्सालयों
naksali	नक्सली	नक्सली
naxali	नक्सली	नै्साली
nagaada	नगाड़ा	नगाड़ा
nagaadaa	नगाड़ा	नगाड़ा
nagaaraa	नगाड़ा	नगाड़ा
nageene	नगीने	नगीनन
nagine	नगीने	नागनन
najarandaaj	नजरंदाज	नजरंदाज
najarandaaz	नजरंदाज	नजारंाज
nazarandaaj	नजरंदाज	नज़रंाज
nazarandaaz	नजरंदाज	नज़रंाज
nazarandaz	नजरंदाज	नजरंदाज
najraane	नजराने	नजराने
nazraane	नजराने	नजररान
najariyon	नजरियों	नजारयों
najriyon	नजरियों	नजरियों
najron	नजरों	नजररं
najeeb	नजीब	नजीी
najib	नजीब	नजजब
najibabaad	नजीबाबाद	नजीबाबाद
najibabad	नजीबाबाद	नजीबाबाद
najeem	नजीम	नजीम
najim	नजीम	नजजम
nazeem	नजीम	नजजी
nana	नना	ननन
nanaa	नना	नना
nna	नना	ननन
nanhe	नन्हें	नन्हे
nanhein	नन्हें	नन्हें
nabj	नब्ज़	नब्ज
nabja	नब्ज़	नब्ज़
nabz	नब्ज़	नब्ज
namkeen	नमकीन	नमकीन
namkin	नमकीन	नमककन
narnaari	नरनारी	नरनारी
narnari	नरनारी	नररररी
narbhakshi	नरभक्षी	नर्भ्षी
naram	नरम	नरर
narm	नरम	ना््
narmi	नरमी	नरमी
narsanhar	नरसंहार	नरराहरर
narsanharon	नरसंहारों	नरराशररों
november	नवंबर	नोवबब
navketan	नवकेतन	नवकेतन
navjaagaran	नवजागरण	नवजागरण
navjagran	नवजागरण	नवजजग्र
navdha	नवधा	नवधा
navvadhoo	नववधू	नववधू
navvadhu	नववधू	नववाधध
nava	नवा	नवा
navaa	नवा	नवा
navate	नवाते	नवाते
navanagar	नवानगर	नवागगर
nawanagar	नवानगर	नवांगर
navya	नव्या	नवयय
naseem	नसीम	नसीम
nasim	नसीम	नसीमम
nights	नाइट्रस	निइट्स
nitrous	नाइट्रस	नाइट्रस
nineteez	नाइनटीज	निननतीज
nineties	नाइनटीज	नाइनटीज
ninties	नाइनटीज	निंटिजस
nau	नाऊ	नौ
nauu	नाऊ	नौऊ
naakaam	नाकाम	नाकाम
nakam	नाकाम	नकममम
naagrik	नागारिक	नाग्रिक
nagarik	नागारिक	नागरििक
nagrik	नागारिक	नागररिक
nagin	नागिन	नागिन
nadep	नाडेप	नाद़प
nanak	नानक	नानक
nanavati	नानावती	नननवतीी
napane	नापने	नापने
napne	नापने	नापने
napa	नापा	नपपा
naam	नाम	नाम
naamdhari	नामधारी	नामधाीी
namdhari	नामधारी	नममधाीी
namankano	नामांकनों	नममानकोों
namankanon	नामांकनों	नामांकनों
namavaliyon	नामावलियों	नममावलियों
naamo	नामो	नामो
namo	नामो	नममो
nayak	नायक	नायक
naraji	नाराजी	नररजजी
naraingarh	नारायणगढ़	नररांगगढ़
narayangadh	नारायणगढ़	नररायंगढ़
narayangarh	नारायणगढ़	नररायंगढ़
naasar	नासर	नासर
nahargadh	नाहरगढ	नहहरगा़़धधधधधधधधधधधधधधधधधधधधधधध
nahargarh	नाहरगढ	नहहरगा़
nikalegi	निकलेगी	निकलेगी
nikalogi	निकलेगी	निकललगी
nikaalani	निकालनी	निकालनी
nikaalni	निकालनी	निकालनी
nikalani	निकालनी	निकललनी
nikalni	निकालनी	निकललनी
nicki	निकी	निकी
nicky	निकी	निकी
niki	निकी	निकी
niketan	निकेतन	निकेतन
nikhar	निखर	निखर
nikhari	निखरी	निखरी
nigar	निगर	निगर
nigger	निगर	निग्
nichala	निचला	निचला
nichalaa	निचला	निचला
nichla	निचला	निचला
nitiyon	नितियों	नितियों
nitya	नित्या	नित्य
nityaa	नित्या	नित्या
nidhaan	निधान	निधान
nidhan	निधान	निधान
nipatara	निपटारा	निपटररा
niptaara	निपटारा	निप्ााा
niptaaraa	निपटारा	निप्ााा
niptara	निपटारा	निप्ारा
niyanta	नियंता	नियंता
niyantaa	नियंता	नियंता
niya	निया	निया
niyaa	निया	निया
nirdeshika	निर्देशिका	निर्देशिका
nirdeshikaa	निर्देशिका	निर्देशिका
nirdhaarit	निर्धारित	निर्धारित
nirdharit	निर्धारित	निर्धारित
nirbaadh	निर्बाध	निर्बाध
nirbadh	निर्बाध	निर्बाध
niveshakartaa	निवेशकर्ता	निवेशककरता
niveshkarta	निवेशकर्ता	निवेशककरतत
niveshkartaa	निवेशकर्ता	निवेशकर्ता
nischal	निश्चल	निस्चल
nishchal	निश्चल	निश्चल
nishnaat	निष्णात	निष्नात
nishpaap	निष्पाप	निष्पाप
nihalaani	निहलानी	निहाानी
nihlaani	निहलानी	निहलानी
nihlani	निहलानी	निहलानी
nihaalchand	निहालचंद	निहालचंड
nihalchand	निहालचंद	निहालंंड
neechaaee	नीचाई	नीचाई
nichaai	नीचाई	निचाई
neat	नीट	नेत
neet	नीट	नीत
neetiyon	नीतियों	नीतियों
nitiyon	नीतियों	नीतियों
neelagaay	नीलगाय	नीलााय
nilgai	नीलगाय	निलगाई
neelaabh	नीलाभ	नीलाभ
nilaabh	नीलाभ	निलाभ
nilabh	नीलाभ	नीलाभ
nuskhe	नुस्खे	नुकखखे
noon	नून	नून
nun	नून	नून
noobiyaa	नूबिया	नूबिया
nubiya	नूबिया	नुबिया
nrityashaili	नृत्यशैली	नृत्याशली
nrutyashaili	नृत्यशैली	नृत्याशली
nrityon	नृत्यों	नृत्यों
nrutyon	नृत्यों	नृत्यों
neco	नेको	नेको
neko	नेको	नेको
nectar	नेक्टर	नेक्टार
neg	नेग	नेग
nega	नेग	नेगा
networking	नेटवर्किग	नेटवरककिंग
neto	नेटो	नेटो
neta	नेता	नेता
nemo	नेमो	नेमो
nelsan	नेल्सन	नेलससन
nelson	नेल्सन	नेल्सन
nations	नेशंस	नेशंस
nehara	नेहरा	नेहरा
nehra	नेहरा	नेहरा
naino	नैनो	नैनो
nano	नैनो	नानो
naivedh	नैवेद्य	नैवेद्य
naivegh	नैवेद्य	नैवेग्ह
nevedya	नैवेद्य	नेवेद्य
nominate	नॉमिनेट	नोमिनेट
naukari	नोकरी	नोकरी
naukri	नोकरी	नौकरी
nokari	नोकरी	नोकरी
nokri	नोकरी	नोकरी
notes	नोट्स	नॉटेस
nora	नोरा	नोरा
nori	नोरी	नोरी
nauner	नौनेर	नौनर
nauvahan	नौवहन	नौवहन
naushad	नौशाद	नौशाद
panchaang	पंचांग	पंचांग
panchang	पंचांग	पंचंंग
punchang	पंचांग	पंंंगग
punjab	पंजाब	पुंबब
punjabiyon	पंजाबियों	पुंबबियों
pantar	पंटर	पंतर
panter	पंटर	पातर
punter	पंटर	पुतर
pakaayein	पकाएं	पकाएए
pakaayen	पकाएं	पकाएं
pakaen	पकाएं	पकाएं
pakayen	पकाएं	पकाएं
pakaude	पकौड़े	पकौड़े
pakshapat	पक्षपात	पक्षाात
pakshpaat	पक्षपात	पक्षपात
pakshpat	पक्षपात	पक्षपतत
pagabadha	पगबाधा	पगगाध
pagbadha	पगबाधा	पगबाधा
pagalaa	पगला	पगला
pagla	पगला	पगला
pachaataa	पचाता	पचाता
pachata	पचाता	पचाता
patakkar	पटककर	पटककर
patkathaayein	पटकथाएं	पतकााएं
patkathaein	पटकथाएं	पटकााएं
patkathayen	पटकथाएं	पतकााएं
patki	पटकी	पतकी
pataraani	पटरानी	पताानी
patrani	पटरानी	पत्ानी
patavaari	पटवारी	पताारी
patwari	पटवारी	पटवारी
pataakshep	पटाक्षेप	पटाक्षेप
patachep	पटाक्षेप	पटाचेप
patakshep	पटाक्षेप	पटकक्षपप
patiya	पटिया	पटिया
patiyaa	पटिया	पटिया
padaraunaa	पडरौना	पडरौना
padrauna	पडरौना	पद्रौा
padega	पड़ेगा	पड़ेगा
padegaa	पड़ेगा	पद़गगा
padha	पढ़ा	पढ़ा
padhaa	पढ़ा	पढ़ा
padhaataa	पढ़ाता	पढ़ाता
padhata	पढ़ाता	पढ़ाता
patili	पतीली	पटिली
padamawati	पदमावती	पदमावती
padmavati	पदमावती	पद्मववी
padmawati	पदमावती	पद्मावी
padadhikari	पदाधिकारी	पद़धिकारी
panapnaa	पनपना	पनपना
panpana	पनपना	पनपना
panaamaa	पनामा	पनामा
panama	पनामा	पनममा
paneer	पनीर	पाीर
pammi	पम्मी	पमममी
pammu	पम्मी	पम्मी
pummi	पम्मी	पुममी
pummy	पम्मी	पूममी
pardesiyon	परदेसियों	पर्डसियों
pardesi	परदेसी	परदेसी
parva	परवा	पर्ा
parvaa	परवा	परवा
parwa	परवा	परवा
parwaa	परवा	परवा
paraadheen	पराधीन	पराधीन
paraadhin	पराधीन	पराधिन
paradheen	पराधीन	पराधीन
paradhin	पराधीन	पराधिन
parikalpit	परिकल्पित	परिकालपित
parimal	परिमल	परिमलल
parishad	परिषद	परिशाद
parishadiy	परिषदीय	परिषदीय
parishadiya	परिषदीय	परिशादिा
parishadon	परिषदों	परिषदों
parikhaen	परीक्षाएं	परिखाएाएं
parikshaayein	परीक्षाएं	परिक्षाएं
parikshaen	परीक्षाएं	परिक्षाएं
parosane	परोसने	परोसने
parosne	परोसने	परोसने
parda	पर्दा	परददा
pardaa	पर्दा	परदाा
purple	पर्पल	पुपपल
palatne	पलटने	पलाने
paltane	पलटने	पल्ने
palaari	पलारी	पलारी
palari	पलारी	पलाीी
pale	पले	पलल
palmonari	पल्मोनरी	पल्मोनरी
pulmonary	पल्मोनरी	पुलमोनरर
plus	पल्स	पल्स
pulse	पल्स	पल्स
pashtun	पश्तून	पशषतुन
pashtuun	पश्तून	पशषतुन
pahan	पहन	पहन
pehan	पहन	पहन
pahantaa	पहनता	पहनता
pahnata	पहनता	पहनाा
pehnate	पहनता	पहनाे
pahanate	पहनते	पहनाे
pahante	पहनते	पहनंे
pehnate	पहनते	पहनते
pahnaakar	पहनाकर	पहनाकर
pahnakar	पहनाकर	पहनाकर
pehnakar	पहनाकर	पहनाकर
pahnaati	पहनाती	पहनाती
pahnati	पहनाती	पहनाती
pehnati	पहनाती	पहनाती
pahani	पहनी	पहनी
pahni	पहनी	पहनी
pehni	पहनी	पहनी
pahno	पहनो	पहनो
pehno	पहनो	पहनो
pahla	पहला	पहला
pahlaa	पहला	पहला
pehla	पहला	पहला
paheliyaan	पहेलियां	पहेलियां
paheliyan	पहेलियां	पहेलियां
paheliyon	पहेलियों	पहेलियों
pide	पाइड	पिइड
pied	पाइड	पिइड
pythagoras	पाइथागोरस	प्इथागगर्
pythogaras	पाइथागोरस	प्इथथगगााा
paakhandi	पाखंडी	पाखंडी
pakhandi	पाखंडी	पखंंडी
paathshaalaayein	पाठशालाएं	पाठशालाएं
pathshalayein	पाठशालाएं	पथथशालयएं
pathshalayen	पाठशालाएं	पथठशालयएं
paathyakram	पाठ्यक्रम	पाठ्यकररमम
pathyakram	पाठ्यक्रम	पथठ्यकररम
pathykram	पाठ्यक्रम	पथठ्यकररम
paathyakramon	पाठ्यक्रमों	पाठ्यकररमों
pathyakramon	पाठ्यक्रमों	पथठ्यकररमों
pathykramon	पाठ्यक्रमों	पाठ्यक्रमों
population	पापुलेशन	पॉपुलतशन
pailot	पायलट	पैलोो
pilot	पायलट	पिललो
pailoton	पायलटों	पैलोोों
piloton	पायलटों	पिललोो
paarampariktaa	पारंपरिकता	पारमपरिकता
paramparikata	पारंपरिकता	परमपपरिकता
paramparikta	पारंपरिकता	परमपपरिकता
parnel	पार्नेल	पररननल
parnell	पार्नेल	पार्नेल
parleron	पार्लरों	परर्लररं
parloron	पार्लरों	परर्लोों
parlouron	पार्लरों	परर्लौों
paarshad	पार्षद	पार्षा
parshad	पार्षद	पररशाद
paarshadon	पार्षदों	पार्षदों
parshadon	पार्षदों	पररशााों
parshdon	पार्षदों	परर्शदों
policy	पालिसी	पॉलीकी
pinta	पिंटा	पिंता
pintaa	पिंटा	पिंटा
piega	पिएगा	पिइगा
piyegaa	पिएगा	पियगग
pic	पिक	पीस
pick	पिक	पिक
pik	पिक	पिक
piki	पिकी	पिकी
piky	पिकी	पिकी
picture	पिक्चर	पिक्टर
pigmentation	पिगमेंटेशन	पिग्ेंटेशन
pigs	पिग्स	पीग्स
pichde	पिछड़े	पिछड़े
pichhade	पिछड़े	पिछड़े
pijja	पिज्जा	पिज्जा
pizza	पिज्जा	पिज़जा
pitaamaha	पितामह	पितामहह
pitamah	पितामह	पिताहह
pipra	पिपरा	पिप्ा
pipraa	पिपरा	पिपरा
pipli	पिपली	पिपली
pearson	पियरसन	पीररसो
pierson	पियरसन	पियरसन
peary	पियरी	पीररी
piyari	पियरी	पियार
pisaai	पिसाई	पिसाई
pisai	पिसाई	पिसाई
pihaani	पिहानी	पिहानी
pihani	पिहानी	पिहानी
pib	पीआईबी	पिबबब
pr	पीआर	प्आर
pml	पीएमएल	एीएम
pmo	पीएमओ	पममम
pmch	पीएमसीएच	एीएच
psv	पीएसवी	पीससीी
peaking	पीकिंग	पेकिंग
picking	पीकिंग	पिकिंग
peetne	पीटने	पीटने
pitne	पीटने	पितने
pedia	पीडिया	पेडिया
pidiya	पीडिया	पिड़या
pidiyaa	पीडिया	पिड़या
peelepan	पीलेपन	पीलेपन
pilepan	पीलेपन	पिलेपन
pv	पीवी	पीवी
pisa	पीसा	पिसा
putla	पुतला	पुटला
putlaa	पुतला	पुटला
putaliyaan	पुतलियां	पुतललयां
putliyan	पुतलियां	पुटलियां
putaliyon	पुतलियों	पूतललयों
putliyon	पुतलियों	पूटलियों
putali	पुतली	पूताी
putli	पुतली	पूटली
putale	पुतले	पुटले
putle	पुतले	पूटले
putin	पुतिन	पूटिन
putul	पुतुल	पूटुल
punargathan	पुनर्गठन	पुनर्गथन
puna	पुना	पुना
puraane	पुराने	पुराने
purane	पुराने	पूराने
puru	पुरू	पुरू
purjon	पुर्जों	पूर्जों
purzon	पुर्जों	पूर्जों
pulam	पुलम	पुलम
pushkin	पुश्किन	पुष्कीन
pushkarana	पुष्करणा	पुष्कााा
pushkarna	पुष्करणा	पुष्करणण
pushkarnaa	पुष्करणा	पुष्कररण
pushp	पुष्प	पुष्प
pushpa	पुष्प	पुष्प
pushpa	पुष्पा	पुष्प
pushpaa	पुष्पा	पुष्पा
pushpit	पुष्पित	पुष्पित
pushpon	पुष्पों	पुष्पों
poonjikaran	पूंजीकरण	पूंजीकरण
punjikaran	पूंजीकरण	पुंजीकरण
poojaapaath	पूजापाठ	पूजापाथ
poojapath	पूजापाठ	पूजापथथ
pujapath	पूजापाठ	पुजापथथ
pooranpur	पूरनपुर	पूरापुर
puranpur	पूरनपुर	पूरनपुर
purvaabhaas	पूर्वाभास	पुर्वाभास
purvaabhas	पूर्वाभास	पुर्वाभा
purvabhaas	पूर्वाभास	पुर्वाभास
purvabhas	पूर्वाभास	पुर्वाभा
pendulam	पेंडुलम	पेंडुलम
pendulum	पेंडुलम	पेंडुलु
peg	पेग	पेग
pages	पेजेज	पाजेज
pajej	पेजेज	पजजेज
pace	पेस	पेस
pes	पेस	पेस
pastry	पेस्ट्री	पेस्ट्री
pangolin	पैंगोलिन	पंंगोलिन
pengolin	पैंगोलिन	पेंगोलिन
packard	पैकर्ड	पैककरडड
package	पैकेज	पैकेज
packageon	पैकेजों	पैकागोो
packagon	पैकेजों	पैकागों
packajon	पैकेजों	पककाजों
paim	पैम	पैम
pam	पैम	पाम
paratrooper	पैराट्रूपर	पररततररप
peratrupers	पैराट्रूपर	पेराटरपप््ससससससससससससससससससससस
paranormal	पैरानॉर्मल	पररणोरममल
peranormal	पैरानॉर्मल	पररानोरमल
paraffin	पैराफिन	पररफफिन
parafin	पैराफिन	पररफफन
perafin	पैराफिन	पेरफफिन
parabola	पैराबोला	पररबोलला
perabola	पैराबोला	पेराबोला
polimer	पॉलिमर	पॉलिमर
polymer	पॉलिमर	पॉल्मर
polishing	पॉलिशिंग	पॉलिशिंग
pokar	पोकर	पोकर
poker	पोकर	पोकर
polish	पोलिश	पोलिश
poshit	पोषित	पोषित
posta	पोस्ता	पोस्टा
pau	पौ	पौऊ
pyade	प्यादे	प्याड
prakriya	प्रक्रिया	प्रक्रिया
prakshepak	प्रक्षेपक	प्रक्षेपक
pratigya	प्रतिज्ञा	प्रतिग्ञ
prtigyaa	प्रतिज्ञा	प्रतिग्ञा
pratibhutiyan	प्रतिभूतियां	प्रतिभूतियां
pratiyon	प्रतियों	प्रतियों
prativaad	प्रतिवाद	प्रतिवाद
prativad	प्रतिवाद	प्रतिवाद
prativadi	प्रतिवादी	प्रतिवादी
pratishat	प्रतिशत	प्रतिशत
praneet	प्रनीत	प्राीत
pranit	प्रनीत	प्राित
prapaat	प्रपात	प्रपात
prapat	प्रपात	प्रपात
prapaaton	प्रपातों	प्रपातों
prapaton	प्रपातों	प्रपातों
prabodhini	प्रबोधिनी	प्रबोधिनी
prayaasrat	प्रयासरत	प्रयासरर
prayasarat	प्रयासरत	प्रयासात
pradarshan	प्रर्दशन	प्रर्दशन
prardashan	प्रर्दशन	प्रर्ाशा
pravati	प्रवत्ति	प्रवाती
pravatti	प्रवत्ति	प्रवा्ति
prashaasanik	प्रशासनिक	प्रशासनिक
prashasanik	प्रशासनिक	प्रशासनिक
prashasnik	प्रशासनिक	प्रशासनिक
prashaasanon	प्रशासनों	प्रशासनों
prashansanon	प्रशासनों	प्रशासनों
prashasanon	प्रशासनों	प्रशासनों
prashikshu	प्रशिक्षु	प्रशिक्षु
prastaavon	प्रस्तावों	प्रस्तावों
prastavon	प्रस्तावों	प्रस्तावों
prahlaad	प्रहलाद	प्रहलाा
prahlad	प्रहलाद	प्रहलाा
prahasan	प्रहसन	प्रहासन
prahsan	प्रहसन	प्रहसा
prahaarak	प्रहारक	प्रहारक
praharak	प्रहारक	प्रहररक
prahad	प्रह्लाद	प्रह्लाद
prahlad	प्रह्लाद	प्रहललाड
privacy	प्राइवेसी	प्रिववा्ी
praakkathan	प्राक्कथन	प्राक्थाा
prakkathan	प्राक्कथन	प्रकक्थान
praan	प्राण	प्रान
pran	प्राण	प्रण
pranon	प्राणों	प्रणनों
prathamik	प्राथमिक	प्रथथमिक
prathmik	प्राथमिक	प्रथथमिक
praathmikata	प्राथमिकता	प्राथमममता
prathmikta	प्राथमिकता	प्राथमिकता
prathmiki	प्राथमिकी	प्रथममिकी
pradhyapakon	प्राध्यापकों	प्राध्यपपकों
prapt	प्राप्त	प्रपप्त
prapta	प्राप्त	प्रपपता
prapti	प्राप्ती	प्रपपतती
praroop	प्रारूप	प्रररूप
prarup	प्रारूप	प्रररुप
priyamani	प्रियामणि	प्रियामणि
proof	प्रूफ	प्रूफ
pruf	प्रूफ	प्रूफ
prekshakon	प्रेक्षकों	प्रेक्षकों
prem	प्रेम	प्रेम
premlata	प्रेमलता	प्रेमलाा
prema	प्रेमा	प्रेमा
premi	प्रेमी	प्रेमी
profit	प्रॉफिट	प्रोफिट
processing	प्रॉसेसिंग	प्रोसेसिंग
programers	प्रोग्रामर्स	प्रोग्रररर्स
programmers	प्रोग्रामर्स	प्रोग्रामर्स
programs	प्रोग्रामर्स	प्रोग्रमम
proto	प्रोटो	प्रोटो
propellant	प्रोपेलेंट	प्रोपललेंट
propellent	प्रोपेलेंट	प्रोपललेंट
praudh	प्रौढ	प्रौढ़
proud	प्रौढ	प्रौढ
plan	प्लेन	प्लान
plane	प्लेन	प्लान
fund	फंड	फंं
funda	फंडा	फुंा
funding	फंडिंग	फंंिंग
fandon	फंदों	फंंोो
fagua	फगुआ	फागग
fatane	फटने	फटने
phatane	फटने	फटने
phatne	फटने	फटने
fadfadata	फड़फड़ाता	फड़फा़ााा
phadphadata	फड़फड़ाता	फड़फा़त
fatehgadh	फतेहगढ़	फटेहगढ़
fatehgarh	फतेहगढ़	फटेहगढ़
fabti	फब्ती	फब्टी
phabti	फब्ती	फब्ती
farse	फरसे	फरसे
pharase	फरसे	फरसेे
pharse	फरसे	फररेे
farheen	फरहीन	फरहहन
farhin	फरहीन	फरहीन
farth	फर्थ	फर्थ
ferth	फर्थ	फर्थ
pharth	फर्थ	फर्थ
farmion	फर्मिऑन	फर्मियन
fermion	फर्मिऑन	फर्मियन
firmian	फर्मिऑन	फिरममयन
farookhabad	फर्रुखाबाद	फर्रुखाबाद
farrukhabad	फर्रुखाबाद	फररखखबाबा
farukhabad	फर्रुखाबाद	फर्रुखाबाद
farookhnagar	फर्रूखनगर	फरूूखनागर
farrukhnagar	फर्रूखनगर	फररुुखागर
farukhnagar	फर्रूखनगर	फरुखखनागर
falata	फलता	फलता
falta	फलता	फलता
phalata	फलता	फलता
falne	फलने	फलने
phalne	फलने	फलने
falitarth	फलितार्थ	फलितरर्थ
phalitartha	फलितार्थ	फलितरर्थ
falibhoot	फलीभूत	फलीभूत
falibhut	फलीभूत	फलीभुत
phalibhoot	फलीभूत	फलीभूत
favvara	फव्वारा	फव्वारा
fawaara	फव्वारा	फवारा
favvare	फव्वारे	फव्वारे
fawaare	फव्वारे	फवाररे
favvaron	फव्वारों	फव्वारों
fawaaron	फव्वारों	फवाररोों
faisala	फ़ैसला	फैससाा
faisla	फ़ैसला	फैिसला
follow	फ़ॉलो	फ़ॉलो
faansi	फांसी	फांसी
fansi	फांसी	फांसी
fatama	फातमा	फटामा
fatma	फातमा	फट्मा
faaf	फाफ	फाफ
phaaph	फाफ	फाफ
farsi	फारसी	फारसी
forcee	फारसी	फॉर्सस
farm	फार्म	फर््म
form	फार्म	फॉर्म
farmic	फार्मिक	फर््मिक
formic	फार्मिक	फॉर्मिक
formulae	फार्मूले	फार्मूले
formule	फार्मूले	फार्मूले
formuley	फार्मूले	फॉर्मूल
pharmacy	फार्मेसी	फरमममैक
pharma	फार्मों	फरमममा
pharmon	फार्मों	फरमममों
farms	फार्म्स	फर््मसस
finger	फिंगर	फिंगर
fikra	फिक्र	फिक्र
physician	फिजिशियन	फिजिशियन
firti	फिरती	फिरती
fisla	फिसला	फिसला
fislaa	फिसला	फिसला
feeder	फीडर	फीडर
fulaaye	फुलाए	फुलाए
fulae	फुलाए	फुलाई
fulay	फुलाए	फुलय
furti	फूर्ति	फूर्ती
phurti	फूर्ति	फूर्ती
fus	फूस	फुस
phoos	फूस	फूस
phus	फूस	फुस
feka	फेका	फेका
fefada	फेफड़ा	फेफड़ा
fefda	फेफड़ा	फेफड़ा
facial	फेशियल	फैकिल
fact	फैक्ट	फैक्ट
federal	फैडरल	फेडरा
failkar	फैलकर	फैलकक
failaaiye	फैलाइए	फैलाइए
failaea	फैलाइए	फैलाई
failaiya	फैलाइए	फैलाइय
failaiye	फैलाइए	फैलैइए
failegi	फैलेगी	फैलेगी
font	फॉन्ट	फॉंंट
fogat	फोगाट	फोगतत
phogat	फोगाट	फोगतत
fod	फोड़	फोड़
phod	फोड़	फोड
foda	फोड़ा	फोडाा
fodaa	फोड़ा	फोडाा
phoda	फोड़ा	फोड़ा
fode	फोड़े	फोड़
phode	फोड़े	फोड़
fodo	फोड़ों	फोडो
fodon	फोड़ों	फोड़ों
phodo	फोड़ों	फोडो
fortis	फोर्टिस	फॉर्टिस
fusion	फ्यूजन	फुसूयन
fuji	फ्यूजी	फ्यूजी
fyuji	फ्यूजी	फ्यूजी
francisca	फ्रांसिस्का	फ्रांसिसकका
franciska	फ्रांसिस्का	फ्रांसिसकका
fransiska	फ्रांसिस्का	फ्रांसससकका
francisco	फ्रांसिस्को	फ्रांसिककको
francisko	फ्रांसिस्को	फ्रांसससकक
fransisko	फ्रांसिस्को	फ्रांसससोक
fringe	फ्रिंज	फ्रिंग
friendship	फ्रेंडशिप	फ्रेंशिपप
frost	फ्रॉस्ट	फ्रॉस्ट
flin	फ्लिन	फ्लीन
flynn	फ्लिन	फ्लाननन
flesh	फ्लेश	फ्लेश
bang	बंग	बागग
bung	बंग	बंं
bangbandhu	बंगबंधु	बंगबंधु
bangbhang	बंगभंग	बंगभंग
bangash	बंगश	बंगाश
bangsh	बंगश	बंग्
bantane	बंटने	बांनन
bantne	बंटने	बांने
bandhati	बंधती	बंंधत
bandhti	बंधती	बंधती
bandhan	बंधान	बंंनन
bandhuon	बंधुओं	बांुूओ
bamba	बंबा	बंबब
mumba	बंबा	मुमब
bakaayon	बकायों	बकायों
bakayon	बकायों	बकायों
bakaul	बकौल	बकलल
bakoul	बकौल	बकलल
baksa	बक्सा	बकसस
baksi	बक्सी	बक्सी
bakse	बक्से	बकसे
bakhshane	बख्शने	बख्षाे
bakhshne	बख्शने	बख्षने
bagad	बगड़	बगग़
bagd	बगड़	बगड़
bageechi	बगीची	बगीची
bagichi	बगीची	बगगची
bachat	बचत	बचात
bachati	बचती	बचती
bachti	बचती	बच्ी
bajana	बजना	बजाा
bajrangi	बजरंगी	बजरागी
bajaj	बजाज	बजजज
batalvi	बटालवी	बतालवी
badhachadhakar	बढ़ाचढ़ाकर	बढ़चचा़कर
badata	बढ़ाता	बद़तता
badhaataa	बढ़ाता	बढ़ाता
badhata	बढ़ाता	बढ़तता
badhaati	बढ़ाती	बढ़ाती
badhati	बढ़ाती	बढ़तती
badhayi	बढ़ायी	बढ़ाई
badhav	बढ़ाव	बा़वव
badhotari	बढ़ोतरी	बढ़ोतार
badhotri	बढ़ोतरी	बढ़ोत्ी
batlaae	बतलाए	बतलाए
batlaaye	बतलाए	बटलाए
batlae	बतलाए	बटलाए
batlaye	बतलाए	बटलाए
batlaakar	बतलाकर	बतलाकर
batlakar	बतलाकर	बतलाकर
badlapur	बदलापुर	बदलापुर
badali	बदली	बदली
badli	बदली	बदली
badam	बदाम	बदाम
banva	बनवा	बनवा
banvaa	बनवा	बनवा
banaam	बनाम	बनाम
banam	बनाम	बनाम
bnaam	बनाम	बनाम
baniya	बनिया	बनिया
banu	बनू	बाुू
barpaayaa	बरपाया	बरपााा
barpaya	बरपाया	बर््या
barsa	बरसा	बरसा
barsaata	बरसाता	बरसाता
barsaataa	बरसाता	बरसाता
barsata	बरसाता	बरसाता
barhad	बरहद	बरहद
baraat	बरात	बरात
barat	बरात	बारत
braat	बरात	ब्ाा
baraamad	बरामद	बराममद
baramad	बरामद	बरामाद
bramad	बरामद	ब्ाममद
baramade	बरामदे	बरामाे
baramde	बरामदे	बरामदे
bare	बरे	बरर
birth	बर्थ	बि््
baljeet	बलजीत	बल्जत
baljit	बलजीत	बलजीत
ballabh	बल्लभ	बलललभ
balla	बल्ला	बललला
balli	बल्ली	बललली
basava	बसावा	बसववा
bastiyon	बस्तियों	बस्तियों
bahroopiya	बहरूपिया	बहरूपिया
bahrupiya	बहरूपिया	बहरुपिय
bahamaas	बहामास	बहममास
bahamas	बहामास	बहममास
bahaav	बहाव	बहाव
bahav	बहाव	बहवव
bhav	बहाव	भाव
bahavalpur	बहावलपुर	बहावलपुर
bahawalpur	बहावलपुर	बहववलपुर
bahuchara	बहुचरा	बहुचाा
banthia	बांठिया	बांठिया
banthiya	बांठिया	बनंठिया
bandhate	बांधते	बंंधते
bandhte	बांधते	बांधते
banbi	बांबी	बनबबी
bombi	बांबी	बांबी
bounceron	बाउंसरों	बौउनसरों
bowling	बाउलिंग	बाउलिंग
baku	बाकू	बकुु
bakuu	बाकू	बाकू
baag	बाग	बाग
bag	बाग	बाग
bagh	बाग	बाघ
bagabani	बागबानी	बगगबननी
bagbani	बागबानी	बगगबानी
bagali	बागली	बगगली
bagli	बागली	बागली
baagiyon	बागियों	बागियों
bagiyon	बागियों	बगगियों
baago	बागो	बागो
bago	बागो	बगगो
baji	बाज़ी	बाज़ी
bazi	बाज़ी	बजजीी
bajaru	बाजारू	बजजर
bazaru	बाजारू	बजजररू
bajuon	बाजुओं	बजजूओं
badh	बाध	बढढ
badha	बाधा	बढधा
baadhaaon	बाधाओं	बाधाओं
baadhaon	बाधाओं	बाधाओं
badhaaon	बाधाओं	बढधाओं
badhaon	बाधाओं	बाधाओं
baadhit	बाधित	बाधित
badhit	बाधित	बढधित
baani	बानी	बानी
bani	बानी	बननी
baapa	बापा	बापा
baapaa	बापा	बापा
bapa	बापा	बापा
bapaa	बापा	बापा
baabat	बाबत	बाबत
babat	बाबत	बबबत
babt	बाबत	बब्त
bayern	बायर्न	बायर्न
byrun	बायर्न	ब्रूून
barah	बारह	बााह
baarahamaasee	बारहमासी	बारहहाससी
barahamasi	बारहमासी	बारहमासी
barahmasi	बारहमासी	बराहमासी
barahsinga	बारहसिंगा	बररहसिंगा
barasingha	बारहसिंगा	बररसिंघहा
bala	बाला	बलला
baalti	बाल्टी	बाल्ती
balti	बाल्टी	बललतीी
balty	बाल्टी	बलल्ीी
baldvin	बाल्डविन	बललद्वीन
baldwin	बाल्डविन	बालद्वीन
bavaji	बावजी	बववजी
bavji	बावजी	बावजी
baawaraa	बावरा	बावाा
bavra	बावरा	बावरा
bawara	बावरा	बवारा
baahulya	बाहुल्य	बाहुल्य
bahuly	बाहुल्य	बहुलली
bahulya	बाहुल्य	बहुलल्य
box	बाॅक्स	बॉकक्स
bikherati	बिखेरती	बिखेरती
bikherti	बिखेरती	बिखेरती
biggest	बिगेस्ट	बिगेस्ट
bichhua	बिछुआ	बिछुआ
bichhuaa	बिछुआ	बिछुआ
biji	बिजी	बीजी
busy	बिजी	बससी
buzy	बिजी	बुज्य
bipin	बिपिन	बिपिन
bilae	बिलाई	बिलाए
bilai	बिलाई	बिलाई
billa	बिल्ला	बिल्ला
billaa	बिल्ला	बिल्ाा
bilhaur	बिल्हौर	बिलहहरर
bisva	बिस्वा	बिस्वा
biswa	बिस्वा	बिस्वा
bag	बीएजी	बागग
bikaner	बीकानेर	बीकानेर
bikaneri	बीकानेरी	बिकननर
bk	बीके	बीक
beejak	बीजक	बीजक
bijak	बीजक	बिजक
beef	बीफ	बीफ
beem	बीम	बीम
bim	बीम	बीम
beemon	बीमों	बीमों
bimon	बीमों	बीमों
beerganj	बीरगंज	बीरगंज
birganj	बीरगंज	बिर्गज
beesavaan	बीसवां	बीसवान
bisavan	बीसवां	बीसवां
bisawan	बीसवां	बिसाान
beast	बीस्ट	बेस्ट
budvig	बुडविग	बुदवीग
budwig	बुडविग	बुडवीग
bull	बुल	बुल्
bulaao	बुलाओ	बुलाओ
bulao	बुलाओ	बुलाओ
bule	बुले	बुले
bulletin	बुलेटिन	बुलेटटन
brijesh	बृजेश	ब्जेश
benvar	बेंवर	बेनवर
benwar	बेंवर	बेनवा
beaulad	बेऔलाद	बायलडड
bekaaboo	बेकाबू	बेकाबू
bekabu	बेकाबू	बेकाबू
bechakar	बेचकर	बेचकर
bechkar	बेचकर	बेककर
bechate	बेचते	बेचते
bechte	बेचते	बेचते
bediyan	बेड़ियां	बेड़ियां
bethanal	बेथनल	बेथनन
bethnal	बेथनल	बेथनल
benis	बेनिस	बेनिस
belacha	बेलचा	बेलाच
belcha	बेलचा	बेलचा
belinda	बेलिंडा	बेलंंडा
bevkufana	बेवकूफाना	बेवकुफनना
bewakoofaanaa	बेवकूफाना	बेवकूफााा
bewkufana	बेवकूफाना	बेवुुफनना
besahaaraa	बेसहारा	बेसहााा
besahara	बेसहारा	बेसहहाा
basin	बेसिन	बेसिन
besin	बेसिन	बेसिन
basil	बेसिल	बससिल
besil	बेसिल	बेसिल
bandage	बैंडेज	बांडगे
bandej	बैंडेज	बैंडेज
baithantey	बैठते	बैठते
baithate	बैठते	बैठते
baitool	बैतूल	बैटूल
baitul	बैतूल	बैटुल
betul	बैतूल	बेटु
baini	बैनी	बैनी
beni	बैनी	बेनी
bairakpur	बैरकपुर	बैरकपुर
barrackpore	बैरकपुर	बररर्कपपर
baila	बैला	बैला
bella	बैला	बेलल
ballistic	बैलिस्टिक	बाल्स्टिक
bells	बैल्स	बेल्स
bostan	बॉस्टन	बोस्टन
bosten	बॉस्टन	बोस्टे
boston	बॉस्टन	बॉस्टन
bokaro	बोकारो	बोकररो
bodara	बोदरा	बोडरा
bodra	बोदरा	बोड्ा
bodraa	बोदरा	बोडरा
bona	बोना	बोना
borkar	बोरकर	बोरकक
borivali	बोरीवली	बोरिवाी
boriwali	बोरीवली	बोरिवाी
born	बोर्न	बोर्न
bolane	बोलने	बोलने
boliae	बोलिए	बोलिए
boliy	बोलिए	बोलिय
boliye	बोलिए	बोलिए
bosaan	बोसान	बोसान
bosan	बोसान	बोसनन
bauni	बौनी	बौनी
bouni	बौनी	बौनी
byaawa	ब्यावर	ब्यावा
byavar	ब्यावर	ब्यववर
brajesh	ब्रजेश	ब्रजेश
brijesh	ब्रजेश	ब्जजेश
brahmalin	ब्रह्मलीन	ब्रह्ममीन
brahmleen	ब्रह्मलीन	ब्रह्ममीन
brahmlin	ब्रह्मलीन	ब्रह्ममीन
bravo	ब्रावो	ब्रवोो
brigatn	ब्रिगटन	ब्रिगटन
brighton	ब्रिगटन	ब्राटटों
brigton	ब्रिगटन	ब्रिटटो
brigadier	ब्रिगेडियर	ब्रागडडर
britain	ब्रिटेन	ब्रिटैं
breed	ब्रीद	ब्रीड
brock	ब्रोक	ब्रॉक
brok	ब्रोक	ब्रोक
broke	ब्रोक	ब्रोक
brocken	ब्रोकन	ब्रॉके
broken	ब्रोकन	ब्रोके
blosam	ब्लॉसम	ब्लोसम
blossom	ब्लॉसम	ब्लोसो
bhagaane	भगाने	भााने
bhagane	भगाने	भागने
bhadakaaya	भड़काया	भड़काया
bhadakaya	भड़काया	भड़काया
bhadkaayaa	भड़काया	भड़काया
bhadkaya	भड़काया	भड़काया
bharakaaya	भड़काया	भऱकाया
bharakaya	भड़काया	भऱकाया
bhabhoot	भभूत	भभूत
bhabhut	भभूत	भभूत
bhay	भय	भा
bhaya	भय	भाा
bhayo	भयो	भाोो
bharatanatyam	भरतनाट्यम्	भररततत्यय
bharatnatyam	भरतनाट्यम्	भररततत्यय
bhartnatyam	भरतनाट्यम्	भर््तत्यय
bharate	भरते	भररे
bharte	भरते	भरते
bharani	भरनी	भरनी
bharni	भरनी	भरनी
bharane	भरने	भरने
bharne	भरने	भरने
bhara	भरा	भाा
bhavishya	भविष्य	भविष्य
bhaate	भाते	भाते
bhate	भाते	भटटे
bhanu	भानू	भानू
bhabar	भाबर	भबबर
bhareeye	भारीय	भरीीय
bhariy	भारीय	भारीय
bhavanaon	भावनाओं	भववनाओं
bhavnaon	भावनाओं	भावनाओं
bhaskar	भास्कर	भससककर
bheed	भीड़	भीड
bheera	भीरा	भीरा
bhira	भीरा	भीरा
bheesham	भीष्म	भीषमम
bhisham	भीष्म	भीष्म
bhishm	भीष्म	भिष्म
bhugat	भुगत	भुगत
bhugata	भुगता	भुगता
bhugta	भुगता	भुगता
bhutto	भुट्टो	भूट्टो
bhumi	भुमि	भूमी
bhurbhura	भुरभुरा	भूर्ुरा
bhookh	भूख	भूख
bhukh	भूख	भुख
bhookhi	भूखी	भूखी
bhukhi	भूखी	भुखी
bhoogol	भूगोल	भूगोल
bhugol	भूगोल	भुगोल
bhootal	भूतल	भूतल
bhutal	भूतल	भूतल
bhoopsingh	भूपसिंह	भूप्िंह
bhupsingh	भूपसिंह	भूप्िंह
bhumi	भूमी	भूमी
bhumika	भूमी	भूमिका
bhulata	भूलता	भुलता
bhulataa	भूलता	भुलता
bhulta	भूलता	भुलता
bhula	भूला	भुला
bhulaa	भूला	भुला
bhooli	भूली	भूली
bhuli	भूली	भुली
bhulo	भूलो	भुलो
bhulon	भूलों	भुलों
bhusi	भूसी	भूसी
bhooswaami	भूस्वामी	भूस्वामी
bhusvami	भूस्वामी	भुस्वामी
bhuswami	भूस्वामी	भुस्वामी
bhengapan	भेंगापन	भेंगपनन
bhairavnath	भैरवनाथ	भैरववाथ
bhairo	भैरो	भैरो
bhogatey	भोगते	भोगते
bhogte	भोगते	भोगते
bhola	भोला	भोला
bholi	भोली	भोली
bholu	भोलू	भोलू
bhaunho	भौंहों	भौनहो
bhaunhon	भौंहों	भौनहों
bhoonhon	भौंहों	भूनहों
bhraant	भ्रांत	भ्रांत
bhrant	भ्रांत	भ्रांट
brant	भ्रांत	ब्रांट
bhraanti	भ्रांति	भ्रांती
bhranti	भ्रांति	भ्रांति
branti	भ्रांति	ब्रांती
bhraantiyan	भ्रांतियां	भ्रांतियां
bhrantiyan	भ्रांतियां	भ्रांतियां
bhraantiyon	भ्रांतियों	भ्रांतियों
bhrantiyon	भ्रांतियों	भ्रांतियों
mangesh	मंगेश	मंगेश
manch	मंच	मां
manchit	मंचित	माचचत
mancheeye	मंचीय	माचीय
manchiy	मंचीय	माचिय
manchiya	मंचीय	मंचीय
manchon	मंचों	मांों
manjil	मंजिल	मंजील
manzil	मंजिल	मंजिल
manjila	मंजिला	मंजीला
manzila	मंजिला	मंजीला
manjilein	मंजिलें	मंजीलें
manjilen	मंजिलें	मंजीलें
manzilein	मंजिलें	मंजीलें
manto	मंटो	मांतो
mantriyon	मंत्रियों	मंत्रियों
makrani	मकरानी	मककरणी
maksad	मक्सद	मककसद
makhdumpur	मखदुमपुर	मखखुुुुु
machaaye	मचाए	मचाए
machae	मचाए	मचाई
machaye	मचाए	मचाए
machaanon	मचानों	मचानों
machanno	मचानों	मचाननं
machano	मचानों	मचानो
machanon	मचानों	मचानों
madaura	मढ़ौरा	मददौरा
madhuara	मढ़ौरा	माधुआा
madhura	मढ़ौरा	माुुरा
manipal	मणिपाल	मानपाल
matpatron	मतपत्रों	मापपतरों
matthe	मत्थे	मत्थे
matsyavatar	मत्स्यावतार	मत्स्यावतार
matsyavtar	मत्स्यावतार	मा्स्यावतार
masyendranath	मत्स्येंद्रनाथ	मससयेंंदररर
matsyendranath	मत्स्येंद्रनाथ	मा्स्येंर्र
madhupur	मधुपुर	मधुपुर
manmarji	मनमर्जी	मा्मरजी
manae	मनाए	मानए
manaye	मनाए	मानए
mnaey	मनाए	मननए
mam	मम	ममम
mum	मम	मुू
maryokar	मयोर्का	मररयोकार
mayorka	मयोर्का	मयोरकका
mayorkaa	मयोर्का	मयोरकका
mardaani	मरदानी	मारदाा
mardani	मरदानी	मरदानी
marmar	मरमर	मररमरर
murmur	मरमर	मूरररर
maratha	मराठा	माराा
marathi	मराठी	मारथी
marji	मर्जी	मारजी
mardanagi	मर्दानगी	मारदाागी
mardangi	मर्दानगी	मारदंगीी
mardo	मर्दों	मारडो
mardon	मर्दों	मारदों
maryaadaa	मर्यादा	मररयााा
maryada	मर्यादा	मररयााा
maryaadaaon	मर्यादाओं	मारयाााओं
maryadaon	मर्यादाओं	मारयादाओं
malaga	मलागा	मलागा
malaar	मलार	मलार
malar	मलार	मालर
mashrak	मशरक	मश््
masaaledaar	मसालेदार	मसालेदार
masaledaar	मसालेदार	मसललेाार
masaledar	मसालेदार	मसललेदरर
masoor	मसूर	माूू
masur	मसूर	मासर
masse	मस्से	मससस
mahakane	महकने	महाकन
mahakne	महकने	महाकन
mahkane	महकने	महकने
mehkane	महकने	मेहके
mahalon	महलों	महाों
mahlon	महलों	महलों
mahagranth	महाग्रंथ	महाग्रंथ
mhagranth	महाग्रंथ	महाग्रंथ
mahajan	महाजन	महाजन
mhajan	महाजन	महाजन
mahathir	महाथिर	महाथिर
mhathir	महाथिर	महहहिर
mahanatam	महानतम	महानतम
mahantam	महानतम	महांतम
mhantam	महानतम	महानतम
mahanideshak	महानिदेशक	महानिदेशक
mahanirdeshak	महानिदेशक	महानिर्््शककककककककककककककककककककक
mhanideshak	महानिदेशक	महानिदेशक
mahapauron	महापौरों	महापौरों
mhapauron	महापौरों	महापूरों
mahapran	महाप्राण	महाप्रणण
mhapran	महाप्राण	महाप्रणण
mahamantr	महामंत्र	महामात्र
mahamantra	महामंत्र	महामात्र
mhamantra	महामंत्र	महामां्र
maharaja	महाराजा	महाराजा
mahavigyan	महाविज्ञान	महाविज्ञान
mhavidyan	महाविज्ञान	महाविद्यान
mahavidya	महाविद्या	महाविद्या
mhavidya	महाविद्या	महाविद्य
mahavishnu	महाविष्णु	महाविशणण
mahasingh	महासिंह	महासिंह
mahasinh	महासिंह	महासिहह
mahipal	महिपाल	महिपाल
mahin	महीन	महहन
mahinon	महीनों	महीनों
maang	मांग	मांग
mang	मांग	मांग
mangani	मांगनी	मंगगनी
mangni	मांगनी	मांगनी
maanga	मांगा	मांगा
manga	मांगा	मंगगा
maangi	मांगी	मांगी
mangi	मांगी	मंगगी
maange	मांगे	मांगे
mange	मांगे	मांगे
mango	मांगो	मंंगो
maori	माओरी	माओरी
maajin	माजिन	माजीन
majin	माजिन	मजजिन
mathe	माथे	माठे
mathey	माथे	माठे
maap	माप	माप
map	माप	माप
mop	माप	माप
mamooli	मामूली	मममूली
mamuli	मामूली	मममूली
mame	मामे	मामे
maarvaad	मारवाड़	मारवाद
marvad	मारवाड़	मररवाद
marwar	मारवाड़	मररवरर
maariya	मारिया	मारिया
mariya	मारिया	मररिया
maariyo	मारियो	मारियो
mario	मारियो	मारियो
mariyo	मारियो	मारियो
martha	मार्था	मरर्था
maalish	मालिश	मालिश
malish	मालिश	मललिश
mave	मावे	मावे
mavey	मावे	मावे
maas	मास	मास
mas	मास	मास
mass	मास	मास
maason	मासों	मासोन
mason	मासों	मासन
mitaao	मिटाओ	मिटाओ
mitao	मिटाओ	मिटाओ
mithaai	मिठाई	मिठाई
mithai	मिठाई	मिथाई
media	मिडिया	मेडिया
mithila	मिथिला	मिथिला
mithilanchal	मिथिलांचल	मिथिलालचल
mithya	मिथ्या	मिथ्य
mimicry	मिमिक्री	मिमिक्री
milkiyat	मिल्कियत	मिलककियत
misha	मिशा	मिशा
mungeri	मुंगेरी	मुंगेरी
mundva	मुंडवा	मुंदवा
mundwa	मुंडवा	मुंडवा
munshiganj	मुंशीगंज	मुंशिगंज
mukarte	मुकरते	मुकर्त
mukartey	मुकरते	मुकरते
mukhopadhyaya	मुखोपाध्याय	मुखोपधय्य
mukhyopadhyaay	मुखोपाध्याय	मुख्पपद्याय
mukhyamantri	मुख्यमंत्री	मुख्ममंत्री
munaf	मुनाफ	मुनाफ
munafa	मुनाफा	मुनाफा
munnu	मुन्नू	मून्नु
mufalisi	मुफलिसी	मुफलीसी
muflisi	मुफलिसी	मुफलिसी
mubarakpur	मुबारकपुर	मुबररपपुर
mubarkpur	मुबारकपुर	मुबररपपुर
murjha	मुर्झा	मूर्झा
multae	मुल्ताई	मुल्ता
multai	मुल्ताई	मुल्ताई
mushahid	मुशाहिद	मुशहहिद
muhavare	मुहावरे	मुहावरे
muhavre	मुहावरे	मुहावरे
mooth	मूठ	मूठ
muth	मूठ	मूठ
mood	मूड	मूड
mud	मूड	मुड
moodi	मूडी	मूद़
moody	मूडी	मूद्
mool	मूल	मूल
mul	मूल	मुल
moolchand	मूलचंद	मूलचंड
mulchand	मूलचंद	मुलचंड
moolar	मूलर	मूलर
mular	मूलर	मुलर
muller	मूलर	मुल्
moolon	मूलों	मूलों
mulon	मूलों	मुलों
maxico	मेक्सिको	मैक्सिको
mexico	मेक्सिको	मेक्सिको
mega	मेगा	मेगा
megapixal	मेगापिक्सल	मेगापिक्लल
megapixel	मेगापिक्सल	मेगापिक्स
mejbaan	मेजबान	मेजबान
mejban	मेजबान	मेजबनन
mezbaan	मेजबान	मेजबान
mejabani	मेजबानी	मेजबननी
mejbaani	मेजबानी	मेजबानी
mejbani	मेजबानी	मेजबननी
mezabani	मेजबानी	मेजबननी
mejbaan	मेज़बान	मेजबानन
mejban	मेज़बान	मेजबननन
mezbaan	मेज़बान	मेजबानन
mejbaani	मेज़बानी	मेजबाननी
mejbani	मेज़बानी	मेजबनननी
mezbaani	मेज़बानी	मेजबाननी
mate	मेट	माट
met	मेट	मेट
mates	मेट्स	मेट्स
medical	मेडीकल	मेडिकल
methanol	मेथेनॉल	मेथानोल
menu	मेनू	मेनु
mem	मेम	मेम
melaghaat	मेलघाट	मेलाघा
melghat	मेलघाट	मेल्घा
melaanin	मेलानिन	मेलानिन
melanin	मेलानिन	मेलानिन
melaani	मेलानी	मेलानी
melani	मेलानी	मेलानी
maheman	मेहमान	महहमान
mehamaan	मेहमान	मेहमान
mehaman	मेहमान	मेहमान
mehmaan	मेहमान	मेहमान
mehman	मेहमान	मेहमनन
meharaam	मेहराम	मेहराम
mehram	मेहराम	मेहररम
macbook	मैकबुक	मैकबू
matix	मैट्रिक्स	मैटिक्क्स
matrix	मैट्रिक्स	मैट्रिक्स
mad	मैड	माड
made	मैड	मैड
maid	मैड	मैड
maddy	मैडी	मदद्य
maidi	मैडी	मैईी
main	मैन	मैन
man	मैन	मान
men	मैन	मेन
mainan	मैनन	मैनन
menon	मैनन	मेनन
manner	मैनर	मैनर
maina	मैना	मैना
maine	मैने	मैने
marrej	मैरेज	मारेज
marriage	मैरेज	मारिगे
merraige	मैरेज	मेररैे
maisachusets	मैसाचुसेट्स	मैसाचुसेट्स
massachusetts	मैसाचुसेट्स	मससाचुसेट्ट
maisor	मैसोर	मैसोर
maisore	मैसोर	मैसोर
mysore	मैसोर	मिसोर
mod	मॉड	मोड
mode	मॉड	मॉड
modern	मॉडर्न	मॉडर्न
module	मॉड्यूल	मोडुल
modules	मॉड्यूल्स	मोडुलसस
modyuls	मॉड्यूल्स	मॉड्यल््
mauritious	मॉरिशस	मौरियिससससससससससससससससससससससससस
mauritius	मॉरिशस	मौरििि्सससससससससससससससससससससससस
mogali	मोगली	मोगली
mowgli	मोगली	मोउ्ी
motive	मोटिव	मोटिव
mol	मोल	मॉल
mold	मोल्ड	मोल्ड
moshe	मोशे	मोशे
mosad	मोसाद	मोसाद
mohana	मोहाना	मोहनना
mohani	मोहानी	मोहननी
mohini	मोहिनी	मोहिनी
mohim	मोहिम	मोहिम
maukon	मौकों	मौकों
mauma	मौमा	मौमा
maurya	मौर्या	मौर्य
morya	मौर्या	मोर्य
maurya	मौर्यों	मौर्यों
mauryon	मौर्यों	मौर्यों
moryon	मौर्यों	मोर्यों
maulaviyon	मौलवियों	मौलवियों
maulvidon	मौलवियों	मौलविदों
maulviyon	मौलवियों	मौलवियों
maule	मौले	मौले
mauley	मौले	मौले
mausa	मौसा	मौसा
yatn	यत्न	या्न
yatna	यत्न	यतनन
yada	यदा	याद
yda	यदा	याा
yaduvansh	यदुवंश	यादवनंशशशशशशशशशशशशशशशशशशशशशशशशश
yaduwansh	यदुवंश	यादवनंशशशशशशशशशशशशशशशशशशशशशशशशश
jerusalem	यरूशलेम	जेरूसेम
yarooshaleim	यरूशलेम	याूशललम
yarushalem	यरूशलेम	याुषललम
yashpaal	यशपाल	यशपाा
yashpal	यशपाल	यशपाल
yaatna	यातना	यातना
yatna	यातना	यतनन
yaatanaon	यातनाओं	यातनाओं
yatnaon	यातनाओं	यततनाओं
yarayan	यात्राएं	यरययय
yatraein	यात्राएं	यतत्राएं
yatraen	यात्राएं	यतत्राएं
yaariyan	यारियां	यारियां
yariyan	यारियां	यारियां
yaari	यारी	यारी
yari	यारी	याीी
yugam	युग्म	युग्म
yugm	युग्म	युग्म
yuddhrat	युद्धरत	युद्धरर
yudhrat	युद्धरत	युद्धरत
ukrainian	यूक्रेनियन	उुकररैनिया
ukranian	यूक्रेनियन	उुकरराणिय
jerusalem	येरुशलम	जेरूसले
yorker	यॉर्कर	यॉर्कर
yojanaein	योजनाएं	योजनाएं
yojanaen	योजनाएं	योजनाएं
yojanaye	योजनाएं	योजनाए
rangate	रंगते	रंगते
rangte	रंगते	रंगते
rangkata	रंजकता	रंगकता
ranjkatha	रंजकता	रंजकाा
ranjkta	रंजकता	रंजकता
raees	रईस	राए
rais	रईस	रास
raktaabh	रक्ताभ	रक्ताभ
raktabh	रक्ताभ	रक्तभभ
rakhna	रखना	रखना
raghupati	रघुपति	रघुपती
raghuram	रघुराम	रघुर्म
registerd	रजिस्टर्ड	रिगस्टर्डड
registered	रजिस्टर्ड	रेगस्टररड
ratanpur	रतनपुर	रानपुर
runners	रनर्स	रु्््
rayan	रयान	राान
ryan	रयान	र्ान
ralhan	रल्हन	रल्हन
ravish	रविश	रविश
ravael	रवैल	रवाल
ravel	रवैल	राेल
rawail	रवैल	रााल
rasad	रसद	रसद
rasaayanik	रसायनिक	रसायनिक
rasaayanika	रसायनिक	रसायनिका
rasayanika	रसायनिक	रसायनिका
rasyanik	रसायनिक	रस्ययननक
rasaayanon	रसायनों	रसायनों
rasayanon	रसायनों	रसायनों
rahamat	रहमत	रहमत
rahmat	रहमत	रहमत
rhamat	रहमत	रहमत
rahenge	रहेंगे	रहहंगे
rahegi	रहेगी	रहहगी
rounder	राउंडर	रुउडडर
raak	राक	राक
rak	राक	रकक
raakhe	राखे	राखे
rakhe	राखे	रखखे
raagon	रागों	रागों
ragon	रागों	रगगों
raghavan	राघवन	रघववा
raaj	राज	राज
raj	राज	राज
rajkot	राजकोट	राजकोत
rajtantra	राजतंत्र	राजतंत्र
raajneetikaran	राजनीतीकरण	राजनीतिकाण
rajneetikaran	राजनीतीकरण	राजनीतिकरण
rajnitikaran	राजनीतीकरण	राजनीतीकरण
rajma	राजमां	राममा
rajman	राजमां	राजमनन
raajasva	राजस्व	राजसवव
rajasva	राजस्व	राजसवव
raaji	राजी	राजी
raji	राजी	राजी
rajinaama	राजीनामा	राजिनामा
rajinama	राजीनामा	राजीनामा
raajon	राजों	राजों
rajon	राजों	राजों
rana	राणा	राणा
raatrichar	रात्रिचर	रात्रिचार
ratrichar	रात्रिचर	रतर्रचचार
raadhe	राधे	राधे
radhe	राधे	राधे
ranapur	रानापुर	रानपुु
rabin	राबिन	रबबिन
robin	राबिन	रोबिन
rabha	राभा	रभभा
ramkot	रामकोट	रामकोत
ramkote	रामकोट	रामकोते
ramtek	रामटेक	रामतेक
rampur	रामपुर	रापपुर
rambharose	रामभरोसे	राभभारस
rambharosey	रामभरोसे	राभभारसे
ramraj	रामराज	रामराज
raalod	रालोद	रालोड
ralaud	रालोद	राौौद
ralod	रालोद	रालोड
ravaley	रावले	रवाले
ravle	रावले	रवलले
rasayanik	रासायनिक	रससयननिक
racreation	रिक्रिएशन	रकक्रेशशन
recreation	रिक्रिएशन	रिक्रिएशन
rig	रिग	रिग
riggs	रिग्स	रिग्स
rigs	रिग्स	रिज्स
richual	रिचुअल	रिचुअल
ritual	रिचुअल	रितुलल
reduction	रिडक्शन	रेजुकशन
ripan	रिपन	रिपन
ripon	रिपन	रिपों
ria	रिया	रिया
riya	रिया	रिया
rishte	रिश्ते	रिष्टे
rishtey	रिश्ते	रिश्ते
risane	रिसने	रिसने
risaney	रिसने	रिसने
risne	रिसने	रिसने
rihana	रिहाना	रिहाना
rihanna	रिहाना	रिहननन
regal	रीगल	रेगल
rigal	रीगल	रिगल
reasonal	रीजनल	रिसोनल
regional	रीजनल	रीजनल
retreate	रीट्वीट	रेत्रेटे
retweet	रीट्वीट	रेटववीट
reeta	रीता	रीता
rita	रीता	रिता
rukate	रुकते	रुकते
rukte	रुकते	रुकते
ruktey	रुकते	रुकते
rugan	रुग्ण	रुगनन
rugna	रुग्ण	रुग्ण
ruganta	रुग्णता	रुगंतता
rugnata	रुग्णता	रुग्नता
rojvelt	रुजवेल्ट	रुजवेल्ट
roojwelt	रुजवेल्ट	रुजवेल्ट
roosevelt	रुजवेल्ट	रूसेेल्ट
rodolph	रुडोल्फ	रोडोलफफ
rudolf	रुडोल्फ	रुडोल्फ
rudolph	रुडोल्फ	रुडोलफफ
roopesh	रुपेश	रूपेश
rupesh	रुपेश	रूपेश
ruby	रुबी	रूबी
roomani	रुमानी	रूमानी
rumani	रुमानी	रूमानी
rukavaton	रूकावटों	रुकावतों
root	रूट	रूट
route	रूट	रोटे
rooting	रूटिंग	रूटिंग
routine	रूटिंग	रोटिन
routing	रूटिंग	रॉटिंग
roots	रूट्स	रूट्स
routes	रूट्स	रॉटेस
roopak	रूपक	रूपक
rupak	रूपक	रूपक
roopi	रूपी	रूपी
rupi	रूपी	रूपी
rantle	रेंटल	रंंलल
rental	रेंटल	रेंटल
registan	रेगिस्तान	रेजिस्टनन
registani	रेगिस्तानी	रेजिस्टननी
reja	रेजा	रेजा
reza	रेजा	रेजा
rate	रेट	रतट
rate	रेत	रेत
ret	रेत	रेट
refaeli	रेफेली	रेफाली
refeli	रेफेली	रेफलली
reshe	रेशे	रेशे
reshey	रेशे	रेशे
race	रेस	रेस
rese	रेस	रेजे
racer	रेसर	रेसर
recer	रेसर	रेकर
racing	रेसिंग	रासिंग
reson	रेसों	रेसोन
rehaana	रेहाना	रहहाना
rehana	रेहाना	रहहना
racketeer	रैकेटियर	रैकेटियर
racketier	रैकेटियर	रककेटीरर
rectare	रैकेटियर	रैकेटियर
radical	रैडिकल	राडिकल
raidical	रैडिकल	रैइिकल
raith	रैथ	रेठ
rapping	रैपिंग	राप्ंग
wrapping	रैपिंग	वाप्ंगग
robertsan	रॉबर्टसन	रोबर्टसस
robertson	रॉबर्टसन	रोबर्ट्ं्
robinson	रॉबिंसन	रोबिंसन
royals	रॉयल्स	रॉयल्स
rojlin	रोजलिन	रोजलिन
rozlyn	रोजलिन	रोजलनन
rotation	रोटेशन	रोटाशन
rodrigo	रोड्रिगो	रोड्रिगो
ronaldo	रोनाल्डो	रोनालडडो
ronit	रोनित	रोनित
roni	रोनी	रोनी
ropane	रोपने	रोपने
ropaney	रोपने	रोपने
ropne	रोपने	रोपने
robin	रोबिन	रोबिन
roya	रोया	रोया
rollers	रोलर्स	रोलर्स
rovan	रोवन	रोवन
rowan	रोवन	रोवन
rosario	रोसारियो	रोसररियो
rosariyo	रोसारियो	रोसरयियो
raubadaar	रौबदार	रौबदार
raubadar	रौबदार	रौबददर
raubdar	रौबदार	रौबददर
landara	लंगड़ा	लंडााा
langada	लंगड़ा	लंगडडा
langda	लंगड़ा	लंगडडा
langar	लंगर	लंगग
langaron	लंगरों	लंगगरं
langron	लंगरों	लंग्रो
lambi	लंबी	लंबी
lakeer	लकीर	लकीर
lakir	लकीर	लककर
lakiron	लकीरों	लकिररं
lakme	लक्मे	लक्मे
lakshmidhar	लक्ष्मीधर	लक्ष्मिधा
lakshmighar	लक्ष्मीधर	लक्ष्मिररर
lakshy	लक्ष्य	लक्ष्य
lakshya	लक्ष्य	लक्ष्य
lakshyon	लक्ष्यों	लक्ष्यों
lux	लक्स	लक्स
laksar	लक्सर	लक्सर
luxor	लक्सर	लक्सर
lakhkhi	लख्खी	लखखखी
lagna	लगना	लगना
laganewale	लगनेवाले	लगनेवाले
lagnevaaley	लगनेवाले	लग्ेेाले
lagnewale	लगनेवाले	लगनेवाले
lagega	लगेगा	लगेगा
lajjalu	लज्जालु	लजजजल
latkate	लटकाते	लटकाते
ladki	लड़की	लड़की
ladate	लड़ते	लड़ते
ladte	लड़ते	लड़ते
ladaai	लड़ाई	लड़ाई
ladai	लड़ाई	लड़ाई
ladaaiyon	लड़ाईयों	लड़ाययों
ladaeyon	लड़ाईयों	लड़ाईयों
ladaiyon	लड़ाईयों	लड़ाययों
lapetane	लपेटने	लपेटेे
lapetne	लपेटने	लपेटनन
labada	लबादा	लबादा
lbada	लबादा	लबबडा
labdh	लब्ध	लब्ध
lbdh	लब्ध	लब््
lalak	ललक	ललकक
lalkarata	ललकारता	ललकररता
lalkarta	ललकारता	ललककतता
lalla	लल्ला	लललला
lavasa	लवासा	लवााा
lovasa	लवासा	लोवसा
lassi	लस्सी	लस्सी
lahanaa	लहना	लहना
lahna	लहना	लहना
lehna	लहना	लहना
lahraee	लहराई	लहराए
lahrai	लहराई	लहराई
lehrayi	लहराई	लहराय
lahalhati	लहलहाती	लहलहतीी
lahlahaati	लहलहाती	लहलहहती
lahlahati	लहलहाती	लहलहहती
lahsun	लहसुन	लहसून
lasoon	लहसुन	लाूून
lanchar	लांचर	लंंचर
launcher	लांचर	लौंचर
lycopene	लाइकोपिन	ल्इकोपेन
lime	लाइम	लाइम
lives	लाइव्स	लिइेसस
live	लाईव	लिवव
laegi	लाएगी	लागगी
lagataar	लागातार	लगगतररर
lagatar	लागातार	लागातार
laata	लाता	लाता
lata	लाता	लटटा
laati	लाती	लाती
lati	लाती	लटटी
layega	लायेगा	लाएेगा
lalpur	लालपुर	लालपुर
las	लास्ट	लास
last	लास्ट	लास्ट
lindbhed	लिंगभेद	लिंडभेद
lingbhed	लिंगभेद	लिंगभेद
lindan	लिंडन	लिंडन
lindn	लिंडन	लांडन
lindon	लिंडन	लिंडोो
likhakar	लिखकर	लिखकर
likhkar	लिखकर	लिखका
ligar	लिगर	लिगर
liger	लिगर	लिगर
liberation	लिबरेशन	लिइरेेशश
libration	लिबरेशन	लिइ््ेनशनशनशशशशशशशशशशशशशशशशशशशश
liberation	लिब्रेशन	लिइररेशन
libration	लिब्रेशन	लिइ्रेशन
leaderon	लीडरों	लीडरों
leedaron	लीडरों	लीदररो
lidaron	लीडरों	लिडररो
liidaron	लीडरों	लिइारो
louis	लुईस	लॉयस
luis	लुईस	लुईस
ludhakate	लुढ़कते	लुढ़कते
ludhkate	लुढ़कते	लुढ़कते
lurhakate	लुढ़कते	लुऱकके
lutf	लुत्फ	लुट्फ
lumding	लुमडिंग	लममडिंग
lootmaar	लूटमार	लूटमार
lootmar	लूटमार	लूटमार
landal	लेंडल	लंंडल
lendal	लेंडल	लेंडल
lega	लेगा	लेगा
legaa	लेगा	लेगा
letakar	लेटकर	लेटकर
letkar	लेटकर	लेटकर
lenevali	लेनेवाली	लेनेवाली
lenewali	लेनेवाली	लेनेवाली
label	लेबल	लाबल
labeling	लेबलिंग	लेबलिंग
labelling	लेबलिंग	लाबेलंं
labelo	लेबलों	लाबेल
labelon	लेबलों	लबबेलं
lebalon	लेबलों	लेबललं
lemon	लेमन	लेमो
laingadan	लैंगडन	लैंगगाा
langdon	लैंगडन	लंंगडोो
lengdan	लैंगडन	लेंगडा
laigikata	लैंगिकता	लैगगकताा
laingikta	लैंगिकता	लैंगिकता
lanset	लैंसेट	लंंसेट
lenset	लैंसेट	लेंसेट
lairi	लैरी	लैरी
lairy	लैरी	लायी
larry	लैरी	लारी
lace	लैस	लेस
less	लैस	लेस
locket	लॉकेट	लोकेट
laundry	लॉन्ड्री	लॉन्ड्री
longewal	लोंगोवाल	लोंगेवलल
longewala	लोंगोवाल	लोंगेवलला
longoval	लोंगोवाल	लोंगोवलल
log	लोग	लोग
loge	लोगे	लोगे
lochdar	लोचदार	लोचडरर
lodi	लोदी	लोडी
laurence	लौरेंस	लौरेंस
laurens	लौरेंस	लौरेंस
laurense	लौरेंस	लौरेंस
wonder	वंडर	वंडर
vansh	वंश	वाश
vanshdhar	वंशधर	वाशधार
vanshavad	वंशवाद	वाशवाद
vanshvaad	वंशवाद	वंशवाद
vanshvad	वंशवाद	वाश्ाद
wanshwad	वंशवाद	वाशवाद
vajood	वजूद	वजूद
vajud	वजूद	वजजद
wajood	वजूद	वजूद
vadali	वडाली	वडाली
vadli	वडाली	वाडली
wadali	वडाली	वा़ली
vanita	वनिता	वािता
vareinye	वरेण्य	वररेनय
varenya	वरेण्य	वरेनयय
varn	वर्ण	वर्ण
varna	वर्ण	वर्न
varnit	वर्णित	वर्णित
vartamaan	वर्तमान	वर्तमान
vartaman	वर्तमान	वर्तममन
vartmaan	वर्तमान	वर्तममन
vartman	वर्तमान	वर्तममन
varddhaman	वर्द्धमान	वर्द्धमनन
vardhmaan	वर्द्धमान	वर्धममानन
vardhman	वर्द्धमान	वर्धममम
verbal	वर्बल	वर्बल
varshan	वर्शन	वर्षन
vasharan	वर्शन	वशषाण
vershan	वर्शन	वर्शन
version	वर्शन	वर्सिन
varsaache	वर्साचे	वरससाचे
varsaryache	वर्साचे	वर्साचे
vasearche	वर्साचे	वससयरचे
valkan	वल्कन	वल्कन
valkkan	वल्कन	वल्कन
velkan	वल्कन	वेलका
vash	वश	वाश
vashikaran	वशीकरण	वशशकरण
vaangchuk	वांगचुक	वांगचकक
vangchuk	वांगचुक	वांचचकक
wangchuk	वांगचुक	वांगचुक
want	वांट	वांट
vije	वाइज	विजज
vise	वाइज	विसज
wise	वाइज	वाइज
vatar	वाटर	वातर
water	वाटर	वाटर
watson	वाटसन	वाटसन
wattson	वाटसन	वाट्सो
vaan	वाण	वान
waan	वाण	वान
vaanon	वाणों	वानों
vanon	वाणों	वानों
wanon	वाणों	वानों
vatanukulan	वातानुकूलन	वातनुुुुल
watanukoollan	वातानुकूलन	वातननुकूलन
vaadak	वादक	वादक
vadak	वादक	वादक
vaadiyon	वादियों	वादियों
vadiyon	वादियों	वादियों
wadiyon	वादियों	वाडियों
vayana	वायना	वायना
vayna	वायना	वायना
wayna	वायना	वायना
wireless	वायरलेस	विररेेज
wirerless	वायरलेस	विररर्््
warrior	वारियर्स	वाररयर
warriors	वारियर्स	वारररर्स
valve	वाल्व	वालवव
wolv	वाल्व	वॉलवव
vastavik	वास्तविक	वसस्तववक
vastvik	वास्तविक	वास्तविक
vaahikayen	वाहिकाएं	वाहिकाएं
vahikayen	वाहिकाएं	वहहिकाएं
wahikayan	वाहिकाएं	वहहिकायं
winter	विंटर	विंटर
vincent	विंसेंट	विंसेंट
vikalpon	विकल्पों	विकल्पों
wicket	विकेट	विकेट
vikramjeet	विक्रमजीत	विक्रमजीत
vikramjit	विक्रमजीत	विक्रमजीत
vichaarakon	विचारकों	विचारकों
vicharakon	विचारकों	विचारकों
vigyan	विज्ञान	विज्ञान
vigyaani	विज्ञानी	विज्ञानी
vigyani	विज्ञानी	विज्ञानी
vigyaanon	विज्ञानों	विज्ञानों
vigyanon	विज्ञानों	विज्ञानों
vitthal	विट्ठल	वित्ठल
viththal	विठ्ठल	विथ्ठल
vitthal	विठ्ठल	वित्थल
vitark	वितर्क	वितर्क
vidhaaein	विद्याएं	विधाएाएं
vidyaayein	विद्याएं	विद्याएं
vidyaen	विद्याएं	विद्याएं
vidhaaon	विद्याओं	विधाााओं
vidyaaon	विद्याओं	विद्याओं
vidyaon	विद्याओं	विद्याओं
vidhansabhaein	विधानसभाएं	विधानसभाएं
vidhansabhaen	विधानसभाएं	विधानसभाएं
vidhivat	विधिवत	विधिवत
vidhut	विधुत	विध्त
vinasht	विनष्ट	विना्ट
vineet	विनीत	विनीत
vinit	विनीत	विनित
vipreetataa	विपरीतता	विप्ीतता
vipritata	विपरीतता	विपरीतता
vipra	विप्रा	विप्र
vipro	विप्रो	विप्रो
wipro	विप्रो	विप्रो
vibha	विभा	विभा
vibhajak	विभाजक	विभाजक
vibhram	विभ्रम	विभ्रम
vibhrm	विभ्रम	विभ्रम
vibram	विभ्रम	विब्ररममममममममममममममममममममममममम
vimarsh	विमर्श	विमा्श
vimarsho	विमर्शों	विमा्शों
vimarshon	विमर्शों	विमा्शों
virajati	विराजती	विराजती
virechan	विरेचन	विरेचन
virodh	विरोध	विरोध
virodhabhasi	विरोधाभासी	विरोधासासी
virodhabhason	विरोधाभासों	विरोधाभासों
vividh	विविध	विविध
vivekahin	विवेकहीन	विवेकहहह
vivekheen	विवेकहीन	विवेकहीन
visheshan	विशेषण	विशेषण
visheshanon	विशेषणों	विशेषणों
visheshaadhikaar	विशेषाधिकार	विशेषाधिकार
visheshadhikar	विशेषाधिकार	विशेषाधिकार
vishwasaniy	विश्वसनीय	विश्वासीय
vishwasniiya	विश्वसनीय	विश्वासीिि
vishwasaniyata	विश्वसनीयता	विश्वासियतत
vishwasniiyataa	विश्वसनीयता	विश्वसनीयता
vishahin	विषहीन	विशहहन
vishhin	विषहीन	विषिणन
vishanu	विष्णु	विशाणु
vishnu	विष्णु	विश्णु
vlc	वीएलसी	ववलल्ीस
weeks	वीक्स	वीक्स
veerchand	वीरचंद	वीरचंड
virchand	वीरचंद	विरचंड
veeresh	वीरेश	वीरेश
viresh	वीरेश	विरेश
vritton	वृत्तों	वृत्टों
vruton	वृत्तों	वृत्तों
vrutton	वृत्तों	वृत्टों
venkataraman	वेंकटरमन	वेंकतरमा
venkatraman	वेंकटरमन	वेंकत्मम
ved	वेड	वेद
wade	वेड	वाडे
wed	वेड	वेड
wedding	वेडिंग	वेदिंग
vediyon	वेदियों	वेदियों
vedon	वेदों	वेदों
venezuela	वेनेजुएला	वेनेजूलला
veronica	वेरोनिका	वररोनिका
veronika	वेरोनिका	वररोणिका
weronika	वेरोनिका	वेरोनिका
velvet	वेलवेट	वेलवेट
welwet	वेलवेट	वेलवेट
welder	वेल्डर	वेल्डर
weldor	वेल्डर	वेल्डर
welding	वेल्डिंग	वेलडडिंग
wealth	वेल्थ	वेल्थ
vellur	वेल्लूर	वेल्रर
velur	वेल्लूर	वेलुरर
vesh	वेश	वेश
wasting	वेस्टिंग	वास्टिंग
westing	वेस्टिंग	वेस्टिंग
wastinghouse	वेस्टिंगहाउस	वास्टिंग
westinghouse	वेस्टिंगहाउस	वेस्टंंग
vaisley	वेस्ले	वेस्ले
vesle	वेस्ले	वेसलल
wesle	वेस्ले	वेसलल
vaigyaanik	वैज्ञानिक	वैज्ञानिक
vaigyanik	वैज्ञानिक	वैज्ञानिक
vegyanik	वैज्ञानिक	वेज्ञानिक
vaigyaanikta	वैज्ञानिकता	वैज्ञानिकता
vaigyanikata	वैज्ञानिकता	वैज्ञानिकता
vaigyanikta	वैज्ञानिकता	वैज्ञानिकता
vaitravati	वैत्रवती	वैत्रवती
vaitrawati	वैत्रवती	वैत्रववी
vaimanasy	वैमनस्य	वैमानस्
vaimanasya	वैमनस्य	वैमानस्
vaimanya	वैमनस्य	वैमान्य
very	वैरी	वेरी
vaisaakh	वैशाख	वैसाख
vaishakh	वैशाख	वैशकख
vaishaakhi	वैशाखी	वैशाखी
vaishakhi	वैशाखी	वैशखखी
vaishnodevi	वैष्णोदेवी	वैष्णोदेवी
vyaktigat	व्यक्तिगत	व्यक्तिगत
vyagr	व्यग्र	व्यग्र
vyagra	व्यग्र	व्यागर
vyatit	व्यतीत	व्यातत
vytit	व्यतीत	व्यतीत
vyabhichar	व्यभिचार	व्यभििार
vyabhichari	व्यभिचार	व्यभििारी
vyavadhan	व्यवधान	व्यवाान
vyavdhan	व्यवधान	व्यवदान
vyavahargat	व्यवहारगत	व्यवहारगग
vyvhargat	व्यवहारगत	व्यवहरर्त
vyaghat	व्याघात	व्याघटत
vyapak	व्यापक	व्याप
vlad	व्लाद	व्लाद
wlaad	व्लाद	वााड
vladimir	व्लादिमीर	व्लाडिमीर
shanghai	शंघाई	शंघाई
shatpath	शतपथ	शतपथ
shanivar	शनिवार	शनिवार
shaniwar	शनिवार	शाीवार
shabana	शबाना	शबनना
shbana	शबाना	शबााा
shabdarth	शब्दार्थ	शब्दरर्थ
shamadan	शमादान	शममानन
shmadan	शमादान	श्मानन
shamitabh	शमिताभ	शमिताभ
shamil	शमिल	शाील
shmil	शमिल	श्ील
sharabon	शराबों	शररबों
shrabon	शराबों	श्ाबों
shararat	शरारत	शरारत
shrart	शरारत	श्ररत
sharmana	शर्माना	शर्माना
shaharwasiyon	शहरवासियों	शहररासियों
shahrvasiyon	शहरवासियों	शहर्वसियों
shervasiyon	शहरवासियों	शेरवासियों
shahdara	शहादरा	शहददाा
shaantikaal	शांतिकाल	शांतिकाल
shantikal	शांतिकाल	शांतिकाल
shaao	शाओ	शाओ
shao	शाओ	शाओ
shaakir	शाकिर	शाकिर
shakir	शाकिर	शककिर
shaakhaaen	शाखाएं	शाखाएं
shakhayan	शाखाएं	शखखायं
shakhayen	शाखाएं	शखखाएं
shayak	शायक	शायक
shaavakon	शावकों	शावकों
shavakon	शावकों	शावकों
shavkon	शावकों	शावकों
shaasaka	शासक	शासका
shasak	शासक	शाकक
sasakon	शासकों	सससकों
shaasakon	शासकों	शासकों
shasakon	शासकों	शासकों
shipra	शिप्रा	शिप्र
shirke	शिर्के	शिरकक
sheershakon	शीर्षकों	शीर्षकों
shirshakon	शीर्षकों	शिर्षकों
shirshkon	शीर्षकों	शिर्षकों
shujaat	शुजात	शुजात
shujat	शुजात	शुजतत
shooting	शुटिंग	शूटिंग
shutting	शुटिंग	शुट्ंग
should	शुड	शौल््ड
shud	शुड	शुड
shubhankar	शुभंकर	शुभाकर
shumaali	शुमाली	शुमाली
shumali	शुमाली	शुमाली
shringaar	शृंगार	श्ंगार
shringar	शृंगार	श्ंगगर
shrungar	शृंगार	श्ंगरर
sheling	शेलिंग	शेलिंग
shelling	शेलिंग	शेल्ंग
shaili	शैली	शैली
shaly	शैली	शा््
sheli	शैली	शेली
shaishav	शैशव	शैष्व
sean	शॉन	सेन
shaun	शॉन	शौन
shawn	शॉन	श्न
short	शोर्ट	शोर्त
sure	श्योर	सुरे
shrankhala	श्रंखला	श्रंखला
shrankhalaa	श्रंखला	श्रंखला
shrunkhla	श्रंखला	श्रंखला
shrankhalaaon	श्रंखलाओं	श्रंखलाओं
shrinkhalaon	श्रंखलाओं	श्रहखलाओं
shrunkhlaon	श्रंखलाओं	श्रखखलाओं
shravani	श्रावणी	श्रववनी
shrikar	श्रीकर	श्रीकर
shrikhand	श्रीखंड	श्रीखंड
shrimati	श्रीमति	श्रीमती
shriram	श्रीराम	श्रीरम
sriram	श्रीराम	श्रीराम
shrotaon	श्रोताओं	श्रोताओं
shat	षट्	शट
sankhyaein	संख्याएं	संखययाएं
sankhyaen	संख्याएं	संख्याएं
sankhyayen	संख्याएं	संख्याएं
sanghanit	संघनित	संघनीत
sanghnit	संघनित	संघनित
sanchayan	संचयन	संचाा
sanchar	संचार	संचार
sanchaari	संचारी	संचारी
sanchari	संचारी	संचारी
sanchalanon	संचालनों	संचालनों
sanchalnon	संचालनों	संचललनों
sanjay	संजय	संजा
sanjeevan	संजीवन	संजीवन
sanjivan	संजीवन	संजीवन
santati	संतति	संतति
sandarbh	संदर्भ	संदर्भ
sandarbha	संदर्भ	संदर्भ
sandrbh	संदर्भ	संद््भभ
sandarbhon	संदर्भों	संदर्भों
sandrbhon	संदर्भों	संद््भभो
sandali	संदली	संदली
sandli	संदली	संदली
sandhan	संधान	संधान
samprati	संप्रति	संप्रती
samprti	संप्रति	संप्रति
samprabhu	संप्रभु	संप्रभु
samprbhu	संप्रभु	संप्रभू
samprabhuta	संप्रभुता	संप्रभुता
samprbhuta	संप्रभुता	संम्रभुत
sambit	संबित	संबिट
sambhalane	संभालने	संभालने
sambhalne	संभालने	संभानने
sambhrant	संभ्रांत	संभ्रंं
sanbharnt	संभ्रांत	संभररंं
sanyog	संयुक्त	सायोग
sanyukt	संयुक्त	सायुक्त
sanyukta	संयुक्त	सायुक्त
sanyukta	संयुक्ता	सायुक्त
sanyogvash	संयोगवश	सायोगवाशशशशशशशशशशशशशशशशशशशशशशशश
sanyojan	संयोजन	सायोजन
sanyojanon	संयोजनों	सायोजनों
sanyojnon	संयोजनों	सायोजनों
samvedikaran	संवेदीकरण	संमेदिकरण
sanvedikaran	संवेदीकरण	संवेदीकरण
samshayon	संशयों	समशाों
sanshayon	संशयों	संशयों
sanshyon	संशयों	संश्ों
sanskaar	संस्कार	संसककार
sanskar	संस्कार	संस्कार
sanskaari	संस्कारी	संस्कारी
sanskari	संस्कारी	संसककारी
sanskrit	संस्कृत	संस्कृत
sanskurt	संस्कृत	संसककृत
sanskritiyan	संस्कृतियां	संस्कृतियां
sanskrutiyan	संस्कृतियां	संस्कृतियां
sanskritiyon	संस्कृतियों	संस्कृतियों
sanskrutiyon	संस्कृतियों	संस्कृतियों
sanasthit	संस्थित	सास्थित
sansthit	संस्थित	संस्थित
sanasthita	संस्थिता	सास्थिता
sansthita	संस्थिता	संस्थिता
sakara	सकरा	सकका
sakra	सकरा	सककर
sakshan	सक्शन	सक्षा
suction	सक्शन	सू््नन
sacchidanand	सच्चिदानंद	सच्चिदननदद
sachhidanand	सच्चिदानंद	सच्दाननं
sachidanand	सच्चिदानंद	सचिदाननं
sajja	सज्जा	सजजज
sat	सत	सतट
satpal	सतपाल	सतपाल
satluj	सतलुज	सतलुज
sataane	सताने	सताने
satane	सताने	सतनने
sate	सते	सतट
satti	सत्ती	सत्ती
satvat	सत्वत	सत्वत
sadanand	सदानंद	सदानंद
sapane	सपने	सपपन
sapne	सपने	सापे
sapney	सपने	सापे
saparivaar	सपरिवार	सपपरवार
sapariwar	सपरिवार	सपपरवार
sparivar	सपरिवार	स्पारिवर
sapaat	सपाट	सपात
sapat	सपाट	सपपत
sapate	सपाटे	सपपते
sapatey	सपाटे	सपपते
saptakranti	सप्तक्रांति	सपपतकररततति
saptkraanti	सप्तक्रांति	सपपतक्रातति
saptapadi	सप्तपदी	सपपतपदी
saptpadi	सप्तपदी	सपपपपदी
saptari	सप्तरी	सपपताी
sapramaan	सप्रमाण	सपपरमान
sapraman	सप्रमाण	सपपरमान
submit	सबमिट	सुबमत
sabmission	सबमिशन	सब्मिनननननननननननननननननननननननननन
submission	सबमिशन	सु्मिनशनननननननननननननननननननननननन
sabhaein	सभाएं	सभाएं
sabhaen	सभाएं	सभाएं
sabhayen	सभाएं	सभायं
sabhen	सभाएं	सभेनं
sabhasadon	सभासदों	सभासदोो
sabhyata	सभ्यता	सभ्यता
samjhoonga	समझूंगा	समझूंगा
samjhunga	समझूंगा	समझुंगा
samjhungaa	समझूंगा	समझुगगा
saman	समन	समम
samanvayaka	समन्वयक	सममनववाााकक
samanwayaka	समन्वयक	सममनवययााक
samnvyak	समन्वयक	सम्््य्क
samaadhaan	समाधान	समाधान
samadhan	समाधान	समाधनन
samadhiyon	समाधियों	समाधियों
samadjiyon	समाधियों	समादजजों
samalakha	समालखा	समलखखा
samalakhaa	समालखा	समलखखा
samahaar	समाहार	समाहार
samahar	समाहार	समाहरर
samitiyan	समितियां	समितियां
sametati	समेटती	समेततत
sametti	समेटती	समेटती
sarka	सरका	सरकक
sarkaa	सरका	सरकाा
sarkarein	सरकारें	सर्ररें
sarkaren	सरकारें	सर्ररें
sarkaaron	सरकारों	सर्ाररं
sarkaron	सरकारों	सर्ररों
sargana	सरगना	सरगना
sarganaon	सरगनाओं	सर्गाओं
sargi	सरगी	सररी
sarguja	सरगुजा	सर्गुज
sarjuga	सरगुजा	सर्ुगग
sarsa	सरसा	सरसा
sarsaa	सरसा	सरसा
sarahind	सरहिंद	सरहहंद
sarhind	सरहिंद	सरहिं
sirhind	सरहिंद	सिरिंं
saraaha	सराहा	सराह
saraha	सराहा	सरहह
saraahi	सराही	सराही
sarahi	सराही	सरहही
salaahkar	सलाहकार	सलाहकरर
salahkaar	सलाहकार	सलाहकार
salahkar	सलाहकार	सलाहकरर
saleeb	सलीब	सलीीब
salib	सलीब	सालब
select	सलेक्ट	सलेक्ट
saltanat	सल्तनत	सल्तनात
saltnat	सल्तनत	सल्टना
savaal	सवाल	सावल
saval	सवाल	सावल
sawaal	सवाल	सााल
sawal	सवाल	सााल
sahakalaakar	सहकलाकार	सहकााकार
sahakalakar	सहकलाकार	सहकाककार
sahkalakar	सहकलाकार	सहकाककार
sahadev	सहदेव	सहाेव
sahdev	सहदेव	सहददव
sahrawat	सहरावत	सहरववत
sherawat	सहरावत	शेरावत
sahooliyata	सहूलियत	सहूलियता
sahuliyat	सहूलियत	सहुलियत
sahuuliyata	सहूलियत	सहूलियत
saanketika	सांकेतिक	सांकेतिका
sanketik	सांकेतिक	संककेतिक
saimans	साइमंस	सैममां
simmons	साइमंस	साइमंस
symons	साइमंस	साइमंस
saima	साइमा	सैममा
sagarika	सागरिका	सगगरिका
sagrika	सागरिका	सगग्िका
saga	सागा	सागा
saajan	साजन	साजन
sajan	साजन	साान
saajsajja	साजसज्जा	साजसजजज
sajsajja	साजसज्जा	सजजसजजज
saja	साजा	सजाा
saathsaath	साथसाथ	साथथाथ
sathsath	साथसाथ	सथथसथथ
sathiya	साथिया	सथथिया
saabah	साबाह	साबहह
sabah	साबाह	साबाह
samanjasy	सामंजस्य	सममंजससस
samanjasya	सामंजस्य	सममंजसयय
samoa	सामोआ	सममा
samoaa	सामोआ	सामोआ
saayn	सायं	सायन
sayan	सायं	सायं
saym	सायं	सायम
saira	सायरा	सैराा
sayara	सायरा	सायरा
sayra	सायरा	सायरा
salve	साल्वे	सललवव
sahab	साहब	सहा
singapore	सिंगापुर	सिंगापोर
singaar	सिंगार	सिंगार
singar	सिंगार	सिंगरर
singer	सिंगार	सिंगरर
singhaadey	सिंघाड़े	सिंघाड़े
singhade	सिंघाड़े	सिंगाड़
singhde	सिंघाड़े	सिंघाड़े
singhre	सिंघाड़े	सिंघाड़े
singhi	सिंघी	सिंघी
singha	सिंहा	सिंघा
sinha	सिंहा	सिनहह
siera	सिएरा	सिइरा
sierra	सिएरा	सिररर
sikud	सिकुड़	सिकुद
signals	सिगनल्स	सिग्नलस
cigaretton	सिगरेटों	सिगाेटटं
cigretton	सिगरेटों	किग्ेटटट
siddhivat	सिद्धवट	सिद्धिववततततततततततततततततततततततत
siddhvat	सिद्धवट	सिद्ध्ात
siddhwat	सिद्धवट	सिद्धवव
sinabang	सिनाबंग	सिनाबंग
synapse	सिनेप्स	सिइापसस
sipah	सिपाह	सिपाह
sipaha	सिपाह	सिपहहा
sipahiyon	सिपाहियों	सिपहहियों
sipahi	सिपाही	सिपहही
sim	सिम	सिम
simat	सिमट	सिमा
simatataa	सिमटता	सिमाता
simatta	सिमटता	सिमातत
simtata	सिमटता	सिमतता
simtataa	सिमटता	सिमतता
cement	सिमटे	सेमेंं
simate	सिमटे	सिमात
simi	सिमी	सिमी
simmy	सिमी	सिम्म
sims	सिम्स	सिम्स
siyasi	सियासी	सियासी
siyah	सियाह	सियाह
siyaha	सियाह	सियाहा
sirpur	सिरपुर	सिरपुर
sivan	सिवान	सिवान
siwan	सिवान	सिवान
sisva	सिसवा	सिस्व
siswa	सिसवा	सिसवा
cil	सीआईएल	सिलललल
csi	सीएसआई	सीएसीई
sikar	सीकर	सिकर
seaten	सीटें	सेटें
sitaram	सीताराम	सितररमम
sitaharan	सीताहरण	सिताररन
cpm	सीपीएम	एीएीएम
cps	सीपीएस	सीपीपसी
cbse	सीबीएसई	सीबीसस
seem	सीम	सीम
sim	सीम	सीम
sealed	सील्ड	सेलेड
shield	सील्ड	शिल्ड
ccd	सीसीडी	सीसीडी
sugamata	सुगमता	सुगमता
sugmta	सुगमता	सुग्ता
sujan	सुजेन	सुजनन
sujen	सुजेन	सुजेन
suken	सुजेन	सुकेन
sujain	सुजैन	सुजान
sujhaati	सुझाती	सुझाती
sujhati	सुझाती	सुझाती
sutali	सुतली	सुटाी
sutli	सुतली	सुटली
suta	सुता	सूटा
sdueep	सुदीप	स्दूयूप
sudip	सुदीप	सुदिप
sudhaargrah	सुधारगृह	सुधारगृह
sudhargrih	सुधारगृह	सुधार््ह
sudhargruh	सुधारगृह	सुधारगृह
sunaaron	सुनारों	सुनारों
sunaron	सुनारों	सुनारों
sunaseer	सुनासीर	सुनासीर
sunasir	सुनासीर	सुनासिर
suneeti	सुनीति	सुनीती
suniti	सुनीति	सुनिति
sunega	सुनेगा	सुनेगा
suneyga	सुनेगा	सुनेगा
superhit	सुपरहिट	सुपरहित
supachy	सुपाच्य	सुपाच्य
supachya	सुपाच्य	सुपचच्य
supachye	सुपाच्य	सुपाच्
subhaay	सुभाय	सुभाय
subhay	सुभाय	सुभाय
surveen	सुरवीन	सूर्ीन
survin	सुरवीन	सुर्िन
surana	सुराणा	सुराना
sulkhan	सुलखान	सुलखान
suljaayi	सुलझाई	सुलजाय
suljayi	सुलझाई	सुलजाई
suljhai	सुलझाई	सुलझाई
sulzai	सुलझाई	सुलझाई
sultana	सुलताना	सुल्ाना
sulaati	सुलाती	सुलाती
sulati	सुलाती	सुलतती
susanskrit	सुसंस्कृत	सुसंसककृत
susanskrut	सुसंस्कृत	सुसंसकृृत
suhagin	सुहागिन	सुहागनन
soond	सूंड़	सूंड़
sund	सूंड़	संंड
suiyan	सूइयां	सुयनन
sukhati	सूखती	सुखती
sukhti	सूखती	सूखती
sukhakar	सूखाकर	सुखककर
soochak	सूचक	सूचक
suchak	सूचक	सुचक
sooja	सूजा	सूजा
suja	सूजा	सुजा
suba	सूबा	सुबा
sube	सूबे	सुबे
sooraj	सूरज	सूरज
suraj	सूरज	सुरा
surinaam	सूरीनाम	सुरिनाम
surinama	सूरीनाम	सुरिनममा
suriname	सूरीनाम	सुरिनमम
suryadev	सूर्यदेव	सुर्यदेव
sendha	सेंधा	सेंधा
senvai	सेंवई	सेनवा
sevai	सेंवई	सेवाा
sensing	सेंसिंग	सेंसिंग
sexual	सेक्सुअल	सेक्सुलल
saturday	सेटरडे	सततु़्
seti	सेटी	सेटी
seto	सेटो	सेटो
seth	सेथ	सेथ
safety	सेफ्टी	सेफ्टी
semen	सेमिन	सेमनन
semin	सेमिन	सेमिन
self	सेल्फ	सेल्फ
selfie	सेल्फी	सेलफफ
save	सेव	सेव
sev	सेव	सेव
sevakon	सेवकों	सेवकोो
sevkon	सेवकों	सेवकों
samuels	सैम्युल्स	सममूयूल्स
celery	सैलरी	केलरी
salary	सैलरी	साारी
sakar	सॉकर	सककर
socar	सॉकर	सोकार
soccer	सॉकर	सोक््र
songs	सॉन्ग्स	सोंंससस
solicitor	सॉलिसिटर	सोलिकटटर
sochane	सोचने	सोचने
sochne	सोचने	सोचने
sonu	सोनू	सोनु
soma	सोमा	सोमा
spma	सोमा	स्पमाा
somi	सोमी	सोमी
soy	सोय	सोय
soya	सोया	सोया
solitaire	सोलिटेयर	सोलिटेयर
soharai	सोहराई	सोहराई
sohrai	सोहराई	सोहराई
sohaval	सोहावल	सोहववल
sohawal	सोहावल	सोहावल
saunpane	सौंपने	सौनपने
sonpne	सौंपने	सोनपने
scala	स्काला	स्काला
skala	स्काला	स्कााा
ski	स्की	सीसी
scootaron	स्कूटरों	स्कूटरों
scooteron	स्कूटरों	स्कूटरों
skootaron	स्कूटरों	स्कूटरों
scandinavia	स्कैंडिनेविया	स्कैंडिनियाया
scaining	स्कैनिंग	स्कैइिंग
scanning	स्कैनिंग	स्काननंग
squash	स्क्वाश	स्क्वाश
squash	स्क्वैश	स्क्वाश
skhalan	स्खलन	स्खलन
stain	स्टैन	स्टेन
stan	स्टैन	स्टान
stop	स्टॉप	स्टोप
stops	स्टॉप्स	स्टॉप्स
stone	स्टोन	स्टोन
straws	स्ट्रास	स्ट्रास
stress	स्ट्रास	स्ट्रेस
stra	स्ट्रे	स्ट्रा
stray	स्ट्रे	स्ट्रे
stre	स्ट्रे	स्ट्रे
strocks	स्ट्रोक्स	स्ट्रोक्स
strokes	स्ट्रोक्स	स्ट्रोकेस
stan	स्तन	स्टा
stanadhari	स्तनधारी	स्ताााधी
standhaari	स्तनधारी	स्तंधााी
standhari	स्तनधारी	स्ताधारी
sthiti	स्तिथि	स्थिती
stithi	स्तिथि	स्तिठी
stuti	स्तुति	स्टटटी
sthitiyaan	स्थितियां	स्थितियां
sthitiyan	स्थितियां	स्थितियां
sthitiyon	स्थितियों	स्थितियों
sthool	स्थूल	स्थूल
sthul	स्थूल	स्थूल
sthoolta	स्थूलता	स्थूलता
sthulata	स्थूलता	स्थुलता
sneakers	स्नीकर्स	स्नेके्स
snickers	स्नीकर्स	स्निकर्स
snikarse	स्नीकर्स	स्निकररस
spear	स्पीयर	स्पीरर
spell	स्पेल	स्पेल
spelar	स्पेलर	स्पेलर
speller	स्पेलर	स्पेलर
sprint	स्प्रिट	स्प्रिं
sprit	स्प्रिट	स्प्रिट
spray	स्प्रे	स्प्रय
spry	स्प्रे	स्प्री
sfoorti	स्फूर्ति	स्फूर्ति
sfurti	स्फूर्ति	स्फूर्ती
sphoorti	स्फूर्ति	स्फूर्ती
slide	स्लाइड	स्लाइड
slider	स्लाइडर	स्लाइड
slaaidon	स्लाइडों	स्लाइडों
slidon	स्लाइडों	स्लिइडो
sliders	स्लाइड्स	स्लाइडरस
slides	स्लाइड्स	स्लाइड
slice	स्लाइस	स्लिइ
slash	स्लैश	स्लाश
swaroopon	स्वरुपों	स्वरुपों
swarupon	स्वरुपों	स्वरूपों
swa	स्वा	स्वा
swaachaalit	स्वाचालित	स्वाचालित
swachalit	स्वाचालित	स्वाचालित
swaarthparak	स्वार्थपरक	स्वार्थपरर
swarthparak	स्वार्थपरक	स्वर््थपरक
swiftlate	स्विफ्टलेट	स्विफ्टलेट
swiftlet	स्विफ्टलेट	स्विफ्टलटट
sweekarte	स्वीकारते	स्वीकारते
swikarte	स्वीकारते	स्वीकररते
sweet	स्वीट	स्वीत
sweep	स्वीप	स्वीप
sweccha	स्वेच्छा	स्वेक्छा
swecha	स्वेच्छा	स्वेच्छा
swechha	स्वेच्छा	स्वेच्छा
sweta	स्वेता	स्वेता
swap	स्वैप	स्वाप
swipe	स्वैप	स्वीप
handiya	हंडिया	हंडिया
handiyaa	हंडिया	हंडिया
hundiya	हंडिया	हंडिया
hakikat	हकीकत	हकिकत
haqeeqat	हकीकत	हकीककत
hathiya	हथिया	हथिया
hamala	हमला	हमला
hamla	हमला	हमला
hamalavar	हमलावर	हमलववर
hamlavar	हमलावर	हमलावर
humlavar	हमलावर	हमलावर
hamaal	हमाल	हमाल
hamal	हमाल	हमलल
hercules	हरक्यूलिस	हेर्कूल्स
hardas	हरदास	हरदसस
harpaal	हरपाल	हरपाल
harpal	हरपाल	हरपाल
harvansh	हरवंश	हरवाश
haraval	हरावल	हरववल
harawal	हरावल	हरावल
hurricane	हरिकेन	हरिकेन
harijan	हरिजन	हरिजन
hariyali	हरियाली	हरियाली
harshit	हर्षित	हर्षित
haldi	हल्दी	हलदडी
halla	हल्ला	हल्ला
hawamahal	हवामहल	हवामहल
hawalaat	हवालात	हवालतत
hawalat	हवालात	हवालतत
hasino	हसीनों	हासनन
hasinon	हसीनों	हससननं
haan	हां	हान
han	हां	हान
haanfte	हांफते	हांफते
hafate	हांफते	हफातेे
hanfte	हांफते	हाफफते
higman	हाइमन	हिगमम
hymen	हाइमन	हाइमन
hadauti	हाड़ौती	हडडौत
haani	हानी	हानी
hani	हानी	हानी
haarjeet	हारजीत	हार्ीत
harjeet	हारजीत	हारजीत
haaranaa	हारना	हाराा
harana	हारना	हरााा
harna	हारना	हरनना
haalchaal	हालचाल	हालचलल
haalchal	हालचाल	हालचल
halchaal	हालचाल	हललचलल
halchal	हालचाल	हललचल
halt	हाल्ट	हलल्
hault	हाल्ट	हाल्
hahakar	हाहाकार	हहहकरर
hingis	हिंगिस	हिंगिस
hindan	हिंडन	हिंदन
hindon	हिंडन	हिंडोो
hijada	हिजड़ा	हिजड़ा
hijda	हिजड़ा	हिजडाा
hijbul	हिजबुल	हिजबूल
hippo	हिप्पो	हिप्पो
hippopotamus	हिप्पोपोटेमस	हिप्पोपटम््स
himali	हिमाली	हिमाली
hilane	हिलने	हिलने
hilne	हिलने	हिलने
hisham	हिशाम	हिशमम
heeraganj	हीरागंज	हीरागंज
hiraganj	हीरागंज	हिरागंज
heroes	हीरोज	हेरोज
heros	हीरोज	हेरोस
hui	हुईं	हुई
huin	हुईं	हिनन
hooper	हूपर	हूपर
huppar	हूपर	हपपरर
hupper	हूपर	हपपर
hegde	हेगडे	हेगडे
hemvati	हेमवती	हेमवाी
hemwati	हेमवती	हेमवाी
help	हेल्प	हेलपप
helper	हेल्पर	हेलपपर
haito	हैतो	हैतो
hairam	हैरम	हैरम
harem	हैरम	हररम
herald	हैराल्ड	हेरलल्ड
haive	हैव	हैवव
have	हैव	हववे
hong	हॉन्ग	होंग
half	हॉफ	हाफ
hoaf	हॉफ	होफ
hounga	होऊंगा	होउगगा
holding	होल्डिंग	हॉलडडिंग
hoshangabaad	होशंगाबाद	होशंगबबा
hoshangabad	होशंगाबाद	होशंगबबा
hostes	होस्टेस	हॉस्टेस
hostess	होस्टेस	हॉस्टेस
